Temple of Indra
You find yourself in a religious ceremony. Three of your fellow monks are gathered before a priest. There are four pedestals north of you, with the priest standing beside them.

You can see a Priest of Indra, Mahit, Basdev and Kastha here.

>look
Final Room
You can see Mahit, Basdev and Kastha here.

Mahit attacks you with Bhaumastra, causing 1 point of damage!

Basdev attacks you with Agneyastra, causing 2 points of damage!

Kastha attacks you with Vayvayastra, causing 1 point of damage!

>die
That's not a verb I recognise.

>x
What do you want to examine?

>nothing
You can't see any such thing.

>die
That's not a verb I recognise.

* * *

>x
What do you want to examine?

>exit
But you aren't in anything at the moment.

>leave
But you aren't in anything at the moment.

>w
You can't go that way.

* * *

>look
Final Room
You can see Mahit, Basdev and Kastha here.

Mahit attacks you with Bhaumastra, causing 1 point of damage!

Basdev attacks you with Agneyastra, causing 2 points of damage!

Kastha attacks you with Vayvayastra, causing 1 point of damage!

>x Drawbridge
The drawbridge looks longer than it actually is; the towers are so high that the tops are lost in cloud, and looking east or west, you cannot see the furthest extent of the walls. An optical illusion: it is smaller inside. Probably.

* * *

>look
Final Room
You can see Mahit, Basdev and Kastha here.

Mahit attacks you with Bhaumastra, causing 1 point of damage!

Basdev attacks you with Agneyastra, causing 2 points of damage!

Kastha attacks you with Vayvayastra, causing 1 point of damage!

>x
(Darkness)
Creeping darkness loons upon you. You feel a chill down your spine.

* * *

>look
Final Room
You can see Mahit, Basdev and Kastha here.

Mahit attacks you with Bhaumastra, causing 1 point of damage!

Basdev attacks you with Agneyastra, causing 2 points of damage!

Kastha attacks you with Vayvayastra, causing 1 point of damage!

>w
You can't go that way.

>walk
You'll have to say which compass direction to go in.

>walk around
You can't see any such thing.

>listen
You hear nothing unexpected.

* * *

>look
Final Room
You can see Mahit, Basdev and Kastha here.

Mahit attacks you with Bhaumastra, causing 1 point of damage!

Basdev attacks you with Agneyastra, causing 2 points of damage!

Kastha attacks you with Vayvayastra, causing 1 point of damage!

>listen
You hear nothing unexpected.

>eat
(Darkness)
That's plainly inedible.

* * *

>look
Final Room
You can see Mahit, Basdev and Kastha here.

Mahit attacks you with Bhaumastra, causing 1 point of damage!

Basdev attacks you with Agneyastra, causing 2 points of damage!

Kastha attacks you with Vayvayastra, causing 1 point of damage!

>x wall
It's too dark to see anything.

>x dark wall
You can't see any such thing.

>x
(the dark wall)
It's too dark to see anything.

>touch wall
It's cold to the touch. You reckon this is just a concrete wall.

* * *

>look
Final Room
You can see Mahit, Basdev and Kastha here.

Mahit attacks you with Bhaumastra, causing 1 point of damage!

Basdev attacks you with Agneyastra, causing 2 points of damage!

Kastha attacks you with Vayvayastra, causing 1 point of damage!

>look
Final Room
You can see Mahit, Basdev and Kastha here.

Mahit attacks you with Bhaumastra, causing 1 point of damage!

Basdev attacks you with Agneyastra, causing 2 points of damage!

Kastha attacks you with Vayvayastra, causing 1 point of damage!

>look
Final Room
You can see Mahit, Basdev and Kastha here.

yourself is dead!

Mahit attacks you with Bhaumastra, finishing you off!

yourself is dead!

Basdev attacks you with Agneyastra, finishing you off!

yourself is dead!

Kastha attacks you with Vayvayastra, finishing you off!

    *** The End ***

Would you like to RESTART, RESTORE a saved game, QUIT or UNDO the last command?

* * *

Temple of Indra
You find yourself in a religious ceremony. Three of your fellow monks are gathered before a priest. There are four pedestals north of you, with the priest standing beside them.

You can see a Priest of Indra, Mahit, Basdev and Kastha here.

>k
That's not a verb I recognise.

* * *

Temple of Indra
You find yourself in a religious ceremony. Three of your fellow monks are gathered before a priest. There are four pedestals north of you, with the priest standing beside them.

You can see a Priest of Indra, Mahit, Basdev and Kastha here.

>z
Time passes.

>z
Time passes.

I beg your pardon?

>zz
That's not a verb I recognise.

>zzz
That's not a verb I recognise.

I beg your pardon?

>x
What do you want to examine?

>a
You can't see any such thing.

>leave
But you aren't in anything at the moment.

* * *

Temple of Indra
You find yourself in a religious ceremony. Three of your fellow monks are gathered before a priest. There are four pedestals north of you, with the priest standing beside them.

You can see a Priest of Indra, Mahit, Basdev and Kastha here.

>go to darkroom
You can't see any such thing.

>go to DarkRoom
You can't see any such thing.

I beg your pardon?

* * *

Temple of Indra
You find yourself in a religious ceremony. Three of your fellow monks are gathered before a priest. There are four pedestals north of you, with the priest standing beside them.

You can see a Priest of Indra, Mahit, Basdev and Kastha here.

>a
That's not a verb I recognise.

>r
That's not a verb I recognise.

>a
That's not a verb I recognise.

I beg your pardon?

I beg your pardon?

>look
???
Você não vê nada

>x room
You can't see any such thing.

>x DarkRoom
You can't see any such thing.

>x ???
You can't see any such thing.

* * *

>a
That's not a verb I recognise.

>look
???
 Your head is not hurting anymore, but you still can't see anything. What about your other senses?

>listen
You hear a faint buzzling sound. You can't pinpoint its location, though.

* * *

Temple of Indra
You find yourself in a religious ceremony. Three of your fellow monks are gathered before a priest. There are four pedestals north of you, with the priest standing beside them.

You can see a Priest of Indra, Mahit, Basdev and Kastha here.

>x
(the dark wall)
There seems to be walls nearby, but you can't see them with your eyes.

>x room
You can't see any such thing.

>x ???
You can't see any such thing.

>xx MausoleuSE
That's not a verb I recognise.

>xMausoleuSE
That's not a verb I recognise.

>x MausoleuSE
You can't see any such thing.

>smell
You smell nothing unexpected.

* * *

>x
(the dark wall)
There seems to be walls nearby, but you can't see them with your eyes.

>walls
You can't see any such thing.

* * *

>x
(the dark wall)
There seems to be walls nearby, but you can't see them with your eyes.

>x mausoleu wall
It's just a wall.

>x wall
It's just a wall.

* * *

>x
(the dark wall)
There seems to be walls nearby, but you can't see them with your eyes.

>x wall
You can't see any such thing.

* * *

>x
(the dark wall)
There seems to be walls nearby, but you can't see them with your eyes.

>wall
You can't see any such thing.

* * *

>x
(the dark wall)
There seems to be walls nearby, but you can't see them with your eyes.

>n
???
 Darkness looms left and right. You feel like you're not alone.

You can see a dark wall here.

>x wall
It's too dark to see anything.

>touch wall
It's cold to the touch. You reckon this is just a concrete wall.

>n
???
 Darkness looms left and right. You feel like you're not alone.

You can see a dark wall here.

>touch wall
It's cold to the touch. You reckon this is just a concrete wall.

>n
You try to walk north, but you hit a wall.

>e
You try to walk east, but you hit a wall.

>touch wall
It's cold to the touch. You reckon this is just a concrete wall.

>e
You try to walk east, but you hit a wall.

>s
???
 Darkness looms left and right. You feel like you're not alone.

You can see a dark wall here.

>s
???
 Darkness looms left and right. You feel like you're not alone.

You can see a dark wall here.

>touch wall
It's cold to the touch. You reckon this is just a concrete wall.

>w
???
 Darkness looms left and right. You feel like you're not alone.

You can see a dark wall here.

>w
???
 Darkness looms left and right. You feel like you're not alone.

You can see a dark wall here.

>touch wall
Instead of the usual cold touch of concrete, you feel a porous surface. Is this wood?

>x wood
You can't see any such thing.

* * *

>x
(the dark wall)
There seems to be walls nearby, but you can't see them with your eyes.

>w
MausoleuS
 Darkness looms left and right. You feel like you're not alone.

>w
MausoleuSW
 Darkness looms left and right. You feel like you're not alone.

>s
You try to walk south, but you hit a wall.

>e
MausoleuS
 Darkness looms left and right. You feel like you're not alone.

>e
MausoleuSE
 Darkness looms left and right. You feel like you're not alone.

>n
MausoleuE
 Darkness looms left and right. You feel like you're not alone.

>n
MausoleuNE
 Darkness looms left and right. You feel like you're not alone.

>w
MausoleuN
 Darkness looms left and right. You feel like you're not alone.

>w
MausoleuNW
 Darkness looms left and right. You feel like you're not alone.

>x
What do you want to examine?

>elevation
You see nothing special about the elevation.

>touch elevation
You feel nothing unexpected.

* * *

>touch wall
It's cold to the touch. You reckon this is just a concrete wall.

>x wall
There seems to be walls nearby, but you can't see them with your eyes.

>punch wal
You can't see any such thing.

>punch wall
You punch the wall, but it doesn't seem to do anything. A great way to hurt your hand.

* * *

Temple of Indra
You find yourself in a religious ceremony. Three of your fellow monks are gathered before a priest. There are four pedestals north of you, with the priest standing beside them.

You can see a Priest of Indra, Mahit, Basdev and Kastha here.

>x darkroom
Eae.

>x mausouleu
You can't see any such thing.

>x
(the darkroom)
Eae.

* * *

Temple of Indra
You find yourself in a religious ceremony. Three of your fellow monks are gathered before a priest. There are four pedestals north of you, with the priest standing beside them.

You can see a Priest of Indra, Mahit, Basdev and Kastha here.

>talk
That's not a verb I recognise.

>speak
I didn't understand that sentence.

* * *

>talk
That's not a verb I recognise.

>ask
Whom do you want to ask?

>priest
What do you want to ask the Priest of Indra for?

>coco
You can't see any such thing.

>ask priest about coco
There is no reply.

* * *

Temple of Indra
You find yourself in a religious ceremony. Three of your fellow monks are gathered before a priest. There are four pedestals north of you, with the priest standing beside them.

You can see a Priest of Indra, Mahit, Basdev and Kastha here.

>x tomb
You see nothing special about the tomb.

* * *

Temple of Indra
You find yourself in a religious ceremony. Three of your fellow monks are gathered before a priest. There are four pedestals north of you, with the priest standing beside them.

You can see a Priest of Indra, Mahit, Basdev and Kastha here.

>listen
You hear a faint buzzling sound. You still can't pinpoint its location, though.

>follow
That's not a verb I recognise.

>smell
You smell nothing unexpected.

* * *

>listen
You hear a faint buzzling sound. You still can't pinpoint its location, though.

>walk north
You can't go that way.

* * *

>listen
You hear a faint buzzling sound. You still can't pinpoint its location, though.

>w
MausoleuS
 Darkness looms left and right. You feel like you're not alone.

>listen
You hear a faint buzzling sound. You can't pinpoint its location, though.

>s
You try to walk south, but you hit a wall

>taste
What do you want to taste?

>eat
(yourself)
You're plainly inedible.

>taste the room
You can't see any such thing.

>eat the room
You can't see any such thing.

>eat the roof
You can't see any such thing.

>roof
That's not a verb I recognise.

>x wall
You can't see any such thing.

* * *

>listen
You hear a faint buzzling sound. You still can't pinpoint its location, though.

>s
MausoleuC
 Your head is not hurting anymore, but you still can't see anything. What about your other senses?

* * *

>listen
You hear a faint buzzling sound. You still can't pinpoint its location, though.

>n
MausoleuE
 Your head is not hurting anymore, but you still can't see anything. What about your other senses?

>listen
You hear a faint buzzling sound. You can't pinpoint its location, though

>n
MausoleuNE
 Your head is not hurting anymore, but you still can't see anything. What about your other senses?

>listen
You hear a faint buzzling sound. You can't pinpoint its location, though

>w
MausoleuN
 Your head is not hurting anymore, but you still can't see anything. What about your other senses?

>listen
The buzzling sound seems to be higher. Its source must be close.

>w
MausoleuNW
 Your head is not hurting anymore, but you still can't see anything. What about your other senses?

>listen
Wow. The buzzling sound is really high here. Maybe this is the source.

* * *

>listen
You hear a faint buzzling sound. You still can't pinpoint its location, though.

>listen
You hear a faint buzzling sound. You can't pinpoint its location, though.

>w
MausoleuS
 Darkness looms left and right. You feel like you're not alone.

* * *

Temple of Indra
You find yourself in a religious ceremony. Three of your fellow monks are gathered before a priest. There are four pedestals north of you, with the priest standing beside them.

You can see a Priest of Indra, Mahit, Basdev and Kastha here.

>n
MausoleuE
Darkness looms left and right. No sign of your pursuer, but you should be cautious anyway.

* * *

I beg your pardon?

>wxit
That's not a verb I recognise.

>exit
But you aren't in anything at the moment.

>die
That's not a verb I recognise.

* * *

>n
MausoleuE
Darkness looms left and right. No sign of your pursuer, but you should be cautious anyway.

>w
MausoleuC
 Darkness looms left and right. You feel like you're not alone.

>e
MausoleuN
 You are laying down in an unknown place. Little by little, you open your eyes, just to realize you can't actually see anything. You can't tell if you're blind or if it's just really dark. Your head is not hurting anymore, but you still can't see anything. What about your other senses?

>e
MausoleuNE
 You are laying down in an unknown place. Little by little, you open your eyes, just to realize you can't actually see anything. You can't tell if you're blind or if it's just really dark. Your head is not hurting anymore, but you still can't see anything. What about your other senses?

>s
MausoleuE
 You are laying down in an unknown place. Little by little, you open your eyes, just to realize you can't actually see anything. You can't tell if you're blind or if it's just really dark. Your head is not hurting anymore, but you still can't see anything. What about your other senses?

>s
MausoleuSE
 You are laying down in an unknown place. Little by little, you open your eyes, just to realize you can't actually see anything. You can't tell if you're blind or if it's just really dark. Your head is not hurting anymore, but you still can't see anything. What about your other senses?

>w
MausoleuS
 You are laying down in an unknown place. Little by little, you open your eyes, just to realize you can't actually see anything. You can't tell if you're blind or if it's just really dark. Your head is not hurting anymore, but you still can't see anything. What about your other senses?

>w
MausoleuSW
 You are laying down in an unknown place. Little by little, you open your eyes, just to realize you can't actually see anything. You can't tell if you're blind or if it's just really dark. Your head is not hurting anymore, but you still can't see anything. What about your other senses?

>n
MausoleuW
 You are laying down in an unknown place. Little by little, you open your eyes, just to realize you can't actually see anything. You can't tell if you're blind or if it's just really dark. Your head is not hurting anymore, but you still can't see anything. What about your other senses?

>n
MausoleuNW
 You are laying down in an unknown place. Little by little, you open your eyes, just to realize you can't actually see anything. You can't tell if you're blind or if it's just really dark. Your head is not hurting anymore, but you still can't see anything. What about your other senses?

>s
MausoleuW
 You are laying down in an unknown place. Little by little, you open your eyes, just to realize you can't actually see anything. You can't tell if you're blind or if it's just really dark. Your head is not hurting anymore, but you still can't see anything. What about your other senses?

>e
MausoleuC
 You are laying down in an unknown place. Little by little, you open your eyes, just to realize you can't actually see anything. You can't tell if you're blind or if it's just really dark. Your head is not hurting anymore, but you still can't see anything. What about your other senses?

>walk left
You can't see any such thing.

>walk
You'll have to say which compass direction to go in.

>walk n
MausoleuN
 Your head is not hurting anymore, but you still can't see anything. What about your other senses?

* * *

>w
MausoleuC
 Darkness looms left and right. You feel like you're not alone.

>x wall
You can't see any such thing.

>n
MausoleuN
 Darkness looms left and right. You feel like you're not alone.

>wall
That's not a verb I recognise.

>x wall
You can't see any such thing.

* * *

>w
MausoleuC
 Darkness looms left and right. You feel like you're not alone.

>n
MausoleuN
 Darkness looms left and right. You feel like you're not alone.

>n
You try to walk north, but you hit a wall.

* * *

>n
MausoleuN
 Darkness looms left and right. You feel like you're not alone.

>w
MausoleuNW
 Darkness looms left and right. You feel like you're not alone.

>touch elevation
The elevation seems to to be about a human's size. You also feel a small gap all around the top of it, like a lid.

* * *

>w
MausoleuC
 Darkness looms left and right. You feel like you're not alone.

>w
MausoleuW
 Darkness looms left and right. You feel like you're not alone.

>n
MausoleuNW
 Darkness looms left and right. You feel like you're not alone.

>x tomb
You see nothing special about the tomb.

>x
What do you want to examine?

>wall
There seems to be walls nearby, but you can't see them with your eyes.

>x tomb
You see nothing special about the tomb.

* * *

>w
MausoleuW
 Darkness looms left and right. You feel like you're not alone.

>w
You try to walk west, but you hit a wall.

>n
MausoleuNW
 Darkness looms left and right. You feel like you're not alone.

>tx firefly
That's not a verb I recognise.

>x firefly
You can't see any such thing.

* * *

>n
MausoleuE
Darkness looms left and right. No sign of your pursuer, but you should be cautious anyway.

>s
MausoleuC
 Your head is not hurting anymore, but you still can't see anything. What about your other senses?

>s
MausoleuS
 Your head is not hurting anymore, but you still can't see anything. What about your other senses?

>s
You try to walk south, but you hit a wall

* * *

>n
MausoleuE
Darkness looms left and right. No sign of your pursuer, but you should be cautious anyway.

>n
MausoleuNE
Darkness looms left and right. No sign of your pursuer, but you should be cautious anyway.

>n
You try to walk north, but you hit a wall.

>n
blah
You can't go that way.

>s
MausoleuC
 Your head is not hurting anymore, but you still can't see anything. What about your other senses?

* * *

>n
You try to walk north, but you hit a wall.

>w
MausoleuN
 Darkness looms left and right. You feel like you're not alone.

* * *

>w
MausoleuNW
 Darkness looms left and right. You feel like you're not alone.

>s
MausoleuW
 Darkness looms left and right. You feel like you're not alone.

>n
You bump into the misterious thing again.

MausoleuNW
 Darkness looms left and right. You feel like you're not alone.

>ceck
That's not a verb I recognise.

>check
What do you want to check?

>thing
You can't see any such thing.

* * *

>feel elevation
The elevation seems to to be about a human's size. You also feel a small gap all around the top of it, like a lid.

>open elevation
You push the lid and it falls to the side of the elevation.

>take firefly
I don't suppose the firefly would care for that.

>x firefly
You see nothing special about the firefly.

>exit
But you aren't in anything at the moment.

* * *

>w
MausoleuN
 Darkness looms left and right. You feel like you're not alone.

>look
MausoleuN
 Darkness looms left and right. You feel like you're not alone.

You can see a dark wall here.

>look at wall
It's too dark to see anything.

* * *

>w
MausoleuN
 Darkness looms left and right. You feel like you're not alone.

I beg your pardon?

>w
MausoleuNW
 Darkness looms left and right. You feel like you're not alone.

>x elevation
The elevation is empty.

>x lid
You can't see any such thing.

>push lid
You can't see any such thing.

* * *

>n
You try to walk north, but you hit a wall.

>x wall
It's just a wall.

>listen
You hear a faint buzzling sound. You still can't pinpoint its location, though.

>w
???
 Darkness looms left and right. You feel like you're not alone.

>x wall
It's just a wall.

>s
???
 Darkness looms left and right. You feel like you're not alone.

>s
???
 Darkness looms left and right. You feel like you're not alone.

>s
You try to walk south, but you hit a wall.

>w
???
 Darkness looms left and right. You feel like you're not alone.

>w
You try to walk west, but you hit a wall.

>e
???
 Darkness looms left and right. You feel like you're not alone.

>n
???
 Darkness looms left and right. You feel like you're not alone.

>x wall
You can't see any such thing.

* * *

>n
MausoleuNE
Darkness looms left and right. No sign of your pursuer, but you should be cautious anyway.

>w
MausoleuN
Darkness looms left and right. No sign of your pursuer, but you should be cautious anyway.

>w
MausoleuNW
Darkness looms left and right. No sign of your pursuer, but you should be cautious anyway.

>x elevation
You can't see what the elevation is, it's too dark.

>x tomb
The elevation is empty.

* * *

>x elevation
You can't see what the elevation is, it's too dark.

>touch elevation
The elevation seems to to be about a human's size. You also feel a small gap all around the top of it, like a lid.

>open elevation
(the elevation)
You push the lid and it falls to the side of the elevation.

White light comes bursting out of the elevation.  When you can finally see again, a giant sprit in the shape of a firefly towers over you. He says "eae men" and flies way, leaving a magic light source, sou you can explore the now lit room.

Mausoleu

>x
What do you want to examine?

>mausoleu
You can't see any such thing.

>vai tomar no cu, inform de merda
You seem to want to talk to someone, but I can't see whom.

* * *

>w
MausoleuNW
Darkness looms left and right. No sign of your pursuer, but you should be cautious anyway.

>open elevation
You push the lid and it falls to the side of the elevation.

>x elevation
You can't see what the elevation is, it's too dark.

>touch elevation
The elevation is could to the touch. It seems to be made of concrete.

>touch lid
You feel nothing unexpected.

>open lid
It isn't something you can open.

>push lid
It is fixed in place.

>take firefly
You can't see any such thing.

* * *

>open elevation
You push the lid and it falls to the side of the elevation.

>touch elevation
The elevation seems to to be about a human's size. You also feel a small gap all around the top of it, like a lid.

* * *

>w
MausoleuNW
Darkness looms left and right. No sign of your pursuer, but you should be cautious anyway.

>w
You try to walk west, but you hit a wall.

>x elevation
You can't see what the elevation is, it's too dark.

>touch elevation
The elevation seems to to be about a human's size. You also feel a small gap all around the top of it, like a lid

* * *

>w
You try to walk west, but you hit a wall.

>x wall
There seems to be walls nearby, but you can't see them with your eyes.

>touch wall
It's cold to the touch. You reckon this is just a concrete wall.

>punch wall
You attack the wall, but it doesn't seem to do anything. A great way to hurt your hand.

>lick wall
That's not a verb I recognise.

>x elevation
You can't see what the elevation is, it's too dark.

* * *

>touch elevation
The elevation seems to to be about a human's size. You also feel a small gap all around the top of it, like a lid.

>push lid
You push the lid and it falls to the side of the elevation.

* * *

>w
MausoleuNW
Darkness looms left and right. No sign of your pursuer, but you should be cautious anyway.

>touch elevation
The elevation seems to to be about a human's size. You also feel a small gap all around the top of it, like a lid.

>open elevation
(the elevation)
You push the lid and it falls to the side of the elevation.

eae men

* * *

>push lid
You push the lid and it falls to the side of the elevation.

>x light spirit
You can't see any such thing.

* * *

>feel the elevation
The elevation seems to to be about a human's size. You also feel a small gap all around the top of it, like a lid.

>push lid
You push the lid and it falls to the side of the elevation.

>x firefly
You see nothing special about the firefly.

* * *

>w
MausoleuNW
Darkness looms left and right. No sign of your pursuer, but you should be cautious anyway.

>x lid
You can't see any such thing.

>touch elevation
The elevation seems to to be about a human's size. You also feel a small gap all around the top of it, like a lid.

>x lid
You see nothing special about the lid.

* * *

>w
MausoleuNW
Darkness looms left and right. No sign of your pursuer, but you should be cautious anyway.

>x light spirit
You can't see any such thing.

>touch elevation
The elevation seems to to be about a human's size. You also feel a small gap all around the top of it, like a lid.

* * *

>push lid
You push the lid and it falls to the side of the elevation.

>x light spirit
I only understood you as far as wanting to examine the light sprit.

>talk to light spirit
That's not a verb I recognise.

>take light spirit
I only understood you as far as wanting to take the light sprit.

* * *

>w
MausoleuN
Darkness looms left and right. No sign of your pursuer, but you should be cautious anyway.

>x wall
You can't see any such thing.

* * *

>w
MausoleuN
Darkness looms left and right. No sign of your pursuer, but you should be cautious anyway.

I beg your pardon?

* * *

>w
MausoleuN
Darkness looms left and right. No sign of your pursuer, but you should be cautious anyway.

>x floor
You can feel the floor under your feet, but you can't see it.

* * *

>n
MausoleuE
Darkness looms left and right. No sign of your pursuer, but you should be cautious anyway.

I beg your pardon?

>n
MausoleuNE
 Darkness looms left and right. You feel like you're not alone.

* * *

>w
MausoleuNW
 Darkness looms left and right. You feel like you're not alone.

>w
You try to walk west, but you hit a wall.

>listen
Wow. The buzzling sound is really high here. Maybe this is the source.

* * *

>n
MausoleuE
Darkness looms left and right. No sign of your pursuer, but you should be cautious anyway.

>x wall
You can't see any such thing.

* * *

Temple of Indra
You find yourself in a religious ceremony. Three of your fellow monks are gathered before a priest. There are four pedestals north of you, with the priest standing beside them.

You can see a Priest of Indra, Mahit, Basdev and Kastha here.

>s
You can't go that way.

>l
MausoleuC
 Your head is not hurting anymore, but you still can't see anything. What about your other senses?

>l
MausoleuC
 Your head is not hurting anymore, but you still can't see anything. What about your other senses?

>x
What do you want to examine?

>room
You can't see any such thing.

* * *

>s
You can't go that way.

>s
You can't go that way.

You'll have to say which compass direction to go in.
I didn't understand that instruction.

I beg your pardon?

>look
MausoleuS
 Your head is not hurting anymore, but you still can't see anything. What about your other senses?

* * *

I beg your pardon?

>s
You can't go that way.

You'll have to say which compass direction to go in.
I didn't understand that instruction.

>s
You can't go that way.

You'll have to say which compass direction to go in.
I didn't understand that instruction.

You hear a loud sound coming from the ceremonial room. The Asura must have broken through the doors. Run, NOW!

>s
You can't go that way.

Asura arrives.

* * *

>s
You can't go that way.

You'll have to say which compass direction to go in.
I didn't understand that instruction.

>s
You try to walk south, but you hit a wall.

* * *

>s
You can't go that way.

You'll have to say which compass direction to go in.
I didn't understand that instruction.

>n
back

>n
You can't go that way.

* * *

>s
You can't go that way.

You'll have to say which compass direction to go in.
I didn't understand that instruction.

>w
Temple Hallway
You run towards the light and find out that there are a few fireflies coming from your left. There is another path straight ahead as well.

>s
Temple Hallway
You run south, feeling the wind blow through your hair. You have no option but to keep running forward.

>s
Temple Hallway
After running a few more meters, you find a wall with a window, from where the wind was blowing. To the right of the window, there's a path with old bookshelves. To the left of the window, there is a path with a few statues of the gods.

>e
Temple Hallway
You run through the hallway past several statues until you reach a wall. The hallway continues south.

>s
Temple Hallway
After running south, you see a rat come running from the path right in front of you. There's another path to the east. They're both dark and you can't see much.

>s
Dark room
You decide to run straight ahead, from where the rat came from. You find yourself in a dark, smelly room filled with rats. You have no business there.

>x rat
You can't see much, but you notice there are more rats than you expected there to be! That's dangerous!

>x rats
You can't see much, but you notice there are more rats than you expected there to be! That's dangerous!

>eat rats
You pick one of the filthy animals and take a bite out of it. You have all the diseases now. Was that worth it?

>eat rat
You pick one of the filthy animals and take a bite out of it. You have all the diseases now. Was that worth it?

>take rat
You try to take a rat with you, but are too scared to do so, given the situation.

>rouch rat
That's not a verb I recognise.

>touch rat
The rat might not like that.

>touch rats
The rat might not like that.

* * *

>s
You try to walk south, but you hit a wall.

>w
MausoleuS
 Darkness looms left and right. You feel like you're not alone.

* * *

>s
You can't go that way.

>look
MausoleuSE
Darkness looms left and right. No sign of your pursuer, but you should be cautious anyway.

* * *

>s
You can't go that way.

>x
What do you want to examine?

* * *

>room
You can't see any such thing.

>look
p2
You run south for a few moments until you reach a wall. The hallway bifurcates to each of your sides, but you see a dim light to your right.

>right
That's not a verb I recognise.

>go right
You can't see any such thing.

>e
d2
You run through the dark eastern path, but you reach a dead end.

>w
p2
You run south for a few moments until you reach a wall. The hallway bifurcates to each of your sides, but you see a dim light to your right.

>e
d2
You run through the dark eastern path, but you reach a dead end.

* * *

>w
p2
You run south for a few moments until you reach a wall. The hallway bifurcates to each of your sides, but you see a dim light to your right.

>w
p3
You run towards the light and find out that there are a few fireflies coming from your left. There is another path straight ahead as well.

>s
p4
You run south, feeling the wind blow through your hair. You have no option but to keep running forward.

>s
p5
After running a few more meters, you find a wall with a window, from where the wind was blowing. To the right of the window, there's a path with old bookshelves. To the left of the window, there is a path with a few statues of the gods.

>s
You can't go that way.

>go though window
You can't see any such thing.

>w
d5
You go to the path with the bookshelves, but it leads to an old library. There's nothing of note inside, and you're in too much of a hurry to take your time here.

>l
d5
You go to the path with the bookshelves, but it leads to an old library. There's nothing of note inside, and you're in too much of a hurry to take your time here.

>e
p5
After running a few more meters, you find a wall with a window, from where the wind was blowing. To the right of the window, there's a path with old bookshelves. To the left of the window, there is a path with a few statues of the gods.

>e
p6
You run through the hallway past several statues until you reach a wall. The hallway continues south.

>s
p7
After running south, you see a rat come running from the path right in front of you. There's another path to the east. They're both dark and you can't see much.

>e
p8
You run east through the dark hallway. You have no option but to keep running forward.

>w
back

>w
You can't go that way.

* * *

>s
You can't go that way.

>n
You try going north, but you remember that's where the Asura are coming from. You give up on that idea and decide to look for another option.

* * *

>s
You can't go that way.

>w
Temple Hallway
You run towards the light and find out that there are a few fireflies coming from your left. There is another path straight ahead as well.

* * *

>s
Temple Hallway
You run south, feeling the wind blow through your hair. You have no option but to keep running forward.

>s
Temple Hallway
After running a few more meters, you find a wall with a window, from where the wind was blowing. To the right of the window, there's a path with old bookshelves. To the left of the window, there is a path with a few statues of the gods.

You hear a loud sound coming from the ceremonial room. The Asura must have broken through the doors. Run, NOW!

>e
Temple Hallway
You run through the hallway past several statues until you reach a wall. The hallway continues south.

Temple Hallway

>s
p7
After running south, you see a rat come running from the path right in front of you. There's another path to the east. They're both dark and you can't see much.

p2

>s
Dark room
You decide to run straight ahead, from where the rat came from. You find yourself in a dark, smelly room filled with rats. You have no business there.

>x rat
You can't see much, but you notice there are more rats than you expected there to be! That's dangerous!

p3

>x rats
You can't see much, but you notice there are more rats than you expected there to be! That's dangerous!

>take a rat
You try to take a rat with you, but are too scared to do so, given the situation.

>eat rats
You pick one of the filthy animals and take a bite out of it. You have all the diseases now. Was that worth it?

>eat a rat
You pick one of the filthy animals and take a bite out of it. You have all the diseases now. Was that worth it?

>eat sime rats
You can't see any such thing.

>eat some rats
You pick one of the filthy animals and take a bite out of it. You have all the diseases now. Was that worth it?

* * *

>x rat
You can't see much, but you notice there are more rats than you expected there to be! That's dangerous!

p3

>eat rat
You pick one of the filthy animals and take a bite out of it. You have all the diseases now. Was that worth it?

>look
Dark room
You decide to run straight ahead, from where the rat came from. You find yourself in a dark, smelly room filled with rats. You have no business there.

>n
p7
You return from the rat-filled room. To the north is the path to the ceremonial room. To the south is the rats" room. The hallway continues to the east.

>e
p8
You run east through the dark hallway. You have no option but to keep running forward.

p3

* * *

>x rat
You can't see much, but you notice there are more rats than you expected there to be! That's dangerous!

p3

>look
Dark room
You decide to run straight ahead, from where the rat came from. You find yourself in a dark, smelly room filled with rats. You have no business there.

p4

>eat rat
You pick one of the filthy animals and take a bite out of it. You have all the diseases now. Was that worth it?

p5

>take rat
You try to take a rat with you, but are too scared to do so, given the situation.

p6

>n
p7
You return from the rat-filled room. To the north is the path to the ceremonial room. To the south is the rats" room. The hallway continues to the east.

    *** As you are about to advance, the gigantic Asura comes flying to your direction. You are caught into its attack and die. 
 Game Over. ***

Would you like to RESTART, RESTORE a saved game, QUIT or UNDO the last command?

* * *

>s
Dark room
You decide to run straight ahead, from where the rat came from. You find yourself in a dark, smelly room filled with rats. You have no business there.

I beg your pardon?

>n
p7
You return from the rat-filled room. To the north is the path to the ceremonial room. To the south is the rats" room. The hallway continues to the east.

p3

* * *

>e
Temple Hallway
You run through the hallway past several statues until you reach a wall. The hallway continues south.

Temple Hallway

I beg your pardon?

>s
Temple Hallway
After running south, you see a rat come running from the path right in front of you. There's another path to the east. They're both dark and you can't see much.

Temple Hallway

>e
Temple Hallway
You run east through the dark hallway. You have no option but to keep running forward.

Temple Hallway

>e
Temple Hallway
Temple Hallway

* * *

>s
Temple Hallway
After running a few more meters, you find a wall with a window, from where the wind was blowing. To the right of the window, there's a path with old bookshelves. To the left of the window, there is a path with a few statues of the gods.

You hear a loud sound coming from the ceremonial room. The Asura must have broken through the doors. Run, NOW!

>w
Library
You go to the path with the bookshelves, but it leads to an old library. There's nothing of note inside, and you're in too much of a hurry to take your time here.

    *** As you are about to advance, the gigantic Asura comes flying to your direction. You are caught into its attack and die. 
 Game Over. ***

Would you like to RESTART, RESTORE a saved game, QUIT or UNDO the last command?

>undo
Temple Hallway
[Previous turn undone.]

>undo
Temple Hallway
[Previous turn undone.]

>s
Temple Hallway
After running a few more meters, you find a wall with a window, from where the wind was blowing. To the right of the window, there's a path with old bookshelves. To the left of the window, there is a path with a few statues of the gods.

You hear a loud sound coming from the ceremonial room. The Asura must have broken through the doors. Run, NOW!

* * *

>w
Library
You go to the path with the bookshelves, but it leads to an old library. There's nothing of note inside, and you're in too much of a hurry to take your time here.

    *** As you are about to advance, the gigantic Asura comes flying to your direction. You are caught into its attack and die. 
 Game Over. ***

Would you like to RESTART, RESTORE a saved game, QUIT or UNDO the last command?

>retore
Please give one of the answers above.

Would you like to RESTART, RESTORE a saved game, QUIT or UNDO the last command?

* * *

>s
Temple Hallway
After running a few more meters, you find a wall with a window, from where the wind was blowing. To the right of the window, there's a path with old bookshelves. To the left of the window, there is a path with a few statues of the gods.

You hear a loud sound coming from the ceremonial room. The Asura must have broken through the doors. Run, NOW!

>x window
You see nothing special about the window.

>go through window
(first opening the window)
You can't, since the window leads nowhere.

* * *

>s
Temple Hallway
After running a few more meters, you find a wall with a window, from where the wind was blowing. To the right of the window, there's a path with old bookshelves. To the left of the window, there is a path with a few statues of the gods.

You hear a loud sound coming from the ceremonial room. The Asura must have broken through the doors. Run, NOW!

>go through window
Outside the 3rd floor

* * *

>s
Temple Hallway
After running a few more meters, you find a wall with a window, from where the wind was blowing. To the right of the window, there's a path with old bookshelves. To the left of the window, there is a path with a few statues of the gods.

You hear a loud sound coming from the ceremonial room. The Asura must have broken through the doors. Run, NOW!

>s
There's a window to the south. Perhaps you could go through it?

>x window
From out the window you can see the blue sky. You seem to be in the 3rd floor.

>go through window
*** You jump through the window and fall to your death. ***

Would you like to RESTART, RESTORE a saved game, QUIT or UNDO the last command?

* * *

>s
Temple Hallway
After running a few more meters, you find a wall with a window, from where the wind was blowing. To the right of the window, there's a path with old bookshelves. To the left of the window, there is a path with a few statues of the gods.

You hear a loud sound coming from the ceremonial room. The Asura must have broken through the doors. Run, NOW!

>z
Time passes.

>z
Time passes.

Asura arrives.

>z
Time passes.

    *** It's too late! As you try to escape, you notice the Asura catching up behind you. Their bloodlust cannot be stopped! You try to run, but all that remains is your soulless corpse on the floor. 
 Game Over. ***

Would you like to RESTART, RESTORE a saved game, QUIT or UNDO the last command?

* * *

>s
Temple Hallway
You run south, feeling the wind blow through your hair. You have no option but to keep running forward.

>go through window
You can't see any such thing.

>x window
You can't see any such thing.

* * *

>w
Temple Hallway
You run towards the light and find out that there are a few fireflies coming from your left. There is another path straight ahead as well.

>x fireflies
You take a brief look at the fireflies, but you're in a hurry and don't see anything special about them.

>x firefly
You can't see any such thing.

>w
Dead end
You run straight ahead, but you reach a dead end.

>x firefly
You can't see any such thing.

* * *

>x fireflies
You take a brief look at the fireflies, but you're in a hurry and don't see anything special about them.

>eat fireflies
That's plainly inedible.

>take fireflies
You try taking a firefly, but you're too scared of the Asura to properly catch any.

>attack fireflies
You lash out on the fireflies, as if they were guilty of your situation. Alas, you tire your arm without acquiring anything. Good job.

>attack firefly
You lash out on the fireflies, as if they were guilty of your situation. Alas, you tire your arm without acquiring anything. Good job.

* * *

>eat fireflies
That's plainly inedible.

>touch fireflies
The firefly might not like that.

>love
That's not a verb I recognise.

>die
That's not a verb I recognise.

* * *

>s
You can't go that way.

>e
Dead end
You run through the dark eastern path, but you reach a dead end.

>w
Temple Hallway
You return from the dead end. To the north is the path to the ceremonial room. To the east is the dead end. The hallway continues to the west, from where you see a dim light.

>s
You can't go that way.

* * *

>w
Temple Hallway
You return from the dead end. To the north is the path to the ceremonial room. To the east is the dead end. The hallway continues to the west, from where you see a dim light.

>w
Temple Hallway
You run towards the light and find out that there are a few fireflies coming from your left. There is another path straight ahead as well.

* * *

>s
You can't go that way.

>d
You try to jump in, but the trap door is still closed.  You hurt your buttocks, but your pride hurts more after such shame.

>open trapdoor
You open the trap door. There's no backing off now, you have no other option but to jump in.

>d
You jump. You have no idea where this will lead you or how high is the fall, but you have no regrets.

MausoleuSE
Darkness looms left and right. No sign of your pursuer, but you should be cautious anyway.

After descending in that hole, you passed away in an unknown place. Little by little, you open your eyes, just to realize you can't actually see anything. You can't tell if you're blind or if it's just really dark. Thankfully, your other senses seems to be working just fine.

You hear a loud sound coming from the ceremonial room. The Asura must have broken through the doors. Run, NOW!

* * *

>s
You can't go that way.

>open trapdoor
You open the trap door. There's no backing off now, you have no other option but to jump in.

>d
You jump. You have no idea where this will lead you or how high is the fall, but you have no regrets.

???
 After descending in that hole, you passed away in an unknown place. Little by little, you open your eyes, just to realize you can't actually see anything. You can't tell if you're blind or if it's just really dark. Thankfully, your other senses seems to be working just fine.

>w
You walk a little to the west, being careful to not bump on any walls or anything on the floor.

???
Darkness looms left and right. No sign of your pursuer, but you should be cautious anyway.

You hear a loud sound coming from the ceremonial room. The Asura must have broken through the doors. Run, NOW!

>w
You walk a little to the west, being careful to not bump on any walls or anything on the floor.

???
Darkness looms left and right. No sign of your pursuer, but you should be cautious anyway.

>w
You try to walk west, but you hit a wall.

>break wall
You attack the wall and it comes tumbling down. 

After breaking the wall, a burst of light comes from outside. On the edge of the hole caused by your punch, you can see some burn marks. It seems the wall iselft was the source of the smell. 
Thankfully, you can see the room now.

Mausoleu

>x wall
You see nothing special about Broken wall.

>x elevation
You see nothing special about Sealed tomb.

* * *

Temple of Indra
You find yourself in a religious ceremony. Three of your fellow monks are gathered before a priest. There are four pedestals north of you, with the priest standing beside them.

You can see a Priest of Indra, Mahit, Basdev and Kastha here.

>FORWARD
That's not a verb I recognise.

>forward
That's not a verb I recognise.

>n
You can't go that way.

>n
You can't go that way.

* * *

Temple of Indra
You find yourself in a religious ceremony. Three of your fellow monks are gathered before a priest. There are four pedestals north of you, with the priest standing beside them.

You can see a Priest of Indra, Mahit, Basdev and Kastha here.

>w
Empty Room
You take the western door, but it leads to an empty room. There's nothing of note inside.

>n
MausoleuC
 Darkness looms left and right. You feel like you're not alone.

>n
MausoleuN
 Darkness looms left and right. You feel like you're not alone.

>m
That's not a verb I recognise.

>n
You can't go that way.

* * *

>n
MausoleuN
 Darkness looms left and right. You feel like you're not alone.

>x wall
You can't see any such thing.

>wall
That's not a verb I recognise.

>look wall
You can't see any such thing.

>wall
That's not a verb I recognise.

>x
What do you want to examine?

>wall
You can't see any such thing.

>walls
That's not a verb I recognise.

* * *

>n
You try to walk north, but you hit a wall.

>w
???
 Darkness looms left and right. You feel like you're not alone.

You can see a mausoleu wall here.

>e
???
 Darkness looms left and right. You feel like you're not alone.

You can see a mausoleu wall here.

>e
???
 Darkness looms left and right. You feel like you're not alone.

You can see a mausoleu wall here.

I beg your pardon?

* * *

>w
MausoleuNW
 Darkness looms left and right. You feel like you're not alone.

>x tomb
The tomb is empty.

>open tomb
It isn't something you can open.

>x lid
You see nothing special about the lid.

>x elevation
The tomb is empty.

* * *

>n
MausoleuC
 Darkness looms left and right. You feel like you're not alone.

>x wall
It's too dark to see anything.

>touch wall
Actually, you can't find any walls in this part.

* * *

>n
MausoleuC
 Darkness looms left and right. You feel like you're not alone.

I beg your pardon?

>n
MausoleuN
 Darkness looms left and right. You feel like you're not alone.

You can see a dark wall here.

* * *

>w
Empty Room
You take the western door, but it leads to an empty room. There's nothing of note inside.

>w
MausoleuSW
 Darkness looms left and right. You feel like you're not alone.

>w
You try to walk west, but you hit a wall.

>w
You can't go that way.

>w
You can't go that way.

I beg your pardon?

>w
You can't go that way.

>e
You can't go that way.

>e
You can't go that way.

>s
You can't go that way.

>s
You can't go that way.

>d
You can't go that way.

* * *

>w
You try to walk west, but you hit a wall.

>n
MausoleuW
 Darkness looms left and right. You feel like you're not alone.

>n
MausoleuNW
 Darkness looms left and right. You feel like you're not alone.

>n
You try to walk north, but you hit a wall.

* * *

>w
MausoleuSW
 Darkness looms left and right. You feel like you're not alone.

>smell
The wet grass must be here. It's smell is somehow pleasing.

* * *

>w
MausoleuSW
 Darkness looms left and right. You feel like you're not alone.

>e
???
 Darkness looms left and right. You feel like you're not alone.

You can see a dark wall here.

>x wall
It's too dark to see anything.

* * *

>w
MausoleuSW
 Darkness looms left and right. You feel like you're not alone.

>punch wall
You punch the wall and it comes tumbling down.

>punch wall
You punch the wall and it comes tumbling down.

* * *

>w
MausoleuSW
 Darkness looms left and right. You feel like you're not alone.

>n
MausoleuW
 Darkness looms left and right. You feel like you're not alone.

* * *

>n
MausoleuNW
 Darkness looms left and right. You feel like you're not alone.

>x tomb
You can't see any such thing.

>x elevation
You see nothing special about the elevation.

>open elevation
It isn't something you can open.

* * *

>w
Empty Room
You take the western door, but it leads to an empty room. There's nothing of note inside.

>e
Temple Hallway
You return to the hallway you were previously. To the north is the ceremonial room from where you came from. To the west and to the east, you see doors. To the south, there's a straight path.

>look
p1
After leaving the ceremonial room, you find yourself in a hallway. To the west and to the east, you see doors. To the south, there's a straight path.

* * *

>e
Temple Hallway
You return to the hallway you were previously. To the north is the ceremonial room from where you came from. To the west and to the east, you see doors. To the south, there's a straight path.

>s
Temple Hallway
You run south for a few moments until you reach a wall. The hallway bifurcates to each of your sides, but you see a dim light to your right.

>w
Temple Hallway
You run towards the light and find out that there are a few fireflies coming from your left. There is another path straight ahead as well.

You hear a loud sound coming from the ceremonial room. The Asura must have broken through the doors. Run, NOW!

>s
Temple Hallway
You run south, feeling the wind blow through your hair. You have no option but to keep running forward.

* * *

>s
Temple Hallway
After running a few more meters, you find a wall with a window, from where the wind was blowing. To the right of the window, there's a path with old bookshelves. To the left of the window, there is a path with a few statues of the gods.

>go through window
*** You jump through the window and fall to your death. ***

Would you like to RESTART, RESTORE a saved game, QUIT or UNDO the last command?

* * *

>listen
You hear a faint buzzling sound. You can't pinpoint its location, though

* * *

>n
MausoleuE
 Darkness looms left and right. You feel like you're not alone.

>w
MausoleuC
 Darkness looms left and right. You feel like you're not alone.

* * *

>n
MausoleuN
 Darkness looms left and right. You feel like you're not alone.

>smell
You smell a faint odor of grass. It's weak though

* * *

Temple of Indra
You find yourself in a religious ceremony. Three of your fellow monks are gathered before a priest. There are four pedestals north of you, with the priest standing beside them.

You can see a Priest of Indra, Mahit, Basdev and Kastha here.

>e
Empty Room
You take the eastern door, but it leads to an empty room. There's nothing of note inside.

>look
MausoleuSE
 Darkness looms left and right. You feel like you're not alone.

* * *

>e
Empty Room
You take the eastern door, but it leads to an empty room. There's nothing of note inside.

>e
You can't go that way.

* * *

>e
Empty Room
You take the eastern door, but it leads to an empty room. There's nothing of note inside.

>w
Temple Hallway
You return to the hallway you were previously. To the north is the ceremonial room from where you came from. To the west and to the east, you see doors. To the south, there's a straight path.

>s
Temple Hallway
You run south for a few moments until you reach a wall. The hallway bifurcates to each of your sides, but you see a dim light to your right.

>w
Temple Hallway
You run towards the light and find out that there are a few fireflies coming from your left. There is another path straight ahead as well.

>w
Dead end
You run straight ahead, but you reach a dead end.

>e
Temple Hallway
You return from the dead end. To the east is the path to the ceremonial room. To the west is the dead end. The hallway continues to the south, from where the fireflies around you are coming from.

* * *

Temple of Indra
You find yourself in a religious ceremony. Three of your fellow monks are gathered before a priest. There are four pedestals north of you, with the priest standing beside them.

You can see a Priest of Indra, Mahit, Basdev and Kastha here.

>examine wall
You can't see any such thing.

>touch wall
You can't see any such thing.

>touch walls
You can't see any such thing.

>x
What do you want to examine?

* * *

Temple of Indra
You find yourself in a religious ceremony. Three of your fellow monks are gathered before a priest. There are four pedestals north of you, with the priest standing beside them.

You can see a Priest of Indra, Mahit, Basdev and Kastha here.

>x wall
You can't see any walls in this darkness. It's like your eyes are totally useless.

>x walls
You can't see any such thing.

* * *

>x wall
You can't see any walls in this darkness. It's like your eyes are totally useless.

>n
MausoleuE
 Darkness looms left and right. You feel like you're not alone.

>x wall
It's just a wall.

>n
MausoleuNE
 Darkness looms left and right. You feel like you're not alone.

>x wall
You can't see any such thing.

* * *

>x wall
It's just a wall.

>s
MausoleuSE
 Darkness looms left and right. You feel like you're not alone.

>x wall
It's just a wall.

>e
You try to walk east, but you hit a wall.

>w
MausoleuS
 Darkness looms left and right. You feel like you're not alone.

>x wall
You can't see any such thing.

>n
MausoleuC
 Darkness looms left and right. You feel like you're not alone.

>x wall
You can't see any such thing.

* * *

>x wall
You can't see any walls in this darkness. It's like your eyes are totally useless.

>s
You try to walk south, but you hit a wall.

>x wall
It's just a wall.

>n
MausoleuE
 Darkness looms left and right. You feel like you're not alone.

* * *

>x wall
You can't see any walls in this darkness. It's like your eyes are totally useless.

>eat wall
You search for a wall, but you can't find any

* * *

>x wall
You can't see any walls in this darkness. It's like your eyes are totally useless.

>x wal
You can't see any such thing.

* * *

>x wall
You can't see any walls in this darkness. It's like your eyes are totally useless.

>x mausoleu wall
It's just a wall.

>x dirty wall
You can't see any such thing.

>n
MausoleuE
 Darkness looms left and right. You feel like you're not alone.

* * *

>x wall
You can't see any walls in this darkness. It's like your eyes are totally useless.

>x
(the dark wall)
It's too dark to see anything.

* * *

>x wall
You can't see any walls in this darkness. It's like your eyes are totally useless.

>touch wall
It's cold to the touch. You reckon this is just a concrete wall.

>punch wall
Violence isn't the answer to this one.

>kill wall
Violence isn't the answer to this one.

>rape wall
That's not a verb I recognise.

>touch wall ar MausoleuSE
I only understood you as far as wanting to touch the mausoleu wall.

>touch wall at MausoleuSE
I only understood you as far as wanting to touch the mausoleu wall.

* * *

Temple of Indra
You find yourself in a religious ceremony. Three of your fellow monks are gathered before a priest. There are four pedestals north of you, with the priest standing beside them.

You can see a Priest of Indra, Mahit, Basdev and Kastha here.

I beg your pardon?

>n
???
 Darkness looms left and right. You feel like you're not alone.

You can see a dark wall here.

>n
MausoleuNE
 Darkness looms left and right. You feel like you're not alone.

>n
You try to walk north, but you hit a wall.

* * *

>w
MausoleuN
 Darkness looms left and right. You feel like you're not alone.

>w
You bump into something amidst the dark. You can't see what it is, but you guess it's about the height of your hip.

MausoleuNW
 Darkness looms left and right. You feel like you're not alone.

>w
You try to walk west, but you hit a wall.

>s
MausoleuW
 Darkness looms left and right. You feel like you're not alone.

>n
You bump into something amidst the dark. You can't see what it is, but you guess it's about the height of your hip.

MausoleuNW
 Darkness looms left and right. You feel like you're not alone.

* * *

>n
???
 Darkness looms left and right. You feel like you're not alone.

You can see a dark wall here.

>w
???
 Darkness looms left and right. You feel like you're not alone.

>touch wall
You can't see any such thing.

>x wall
You can't see any such thing.

* * *

Temple of Indra
You find yourself in a religious ceremony. Three of your fellow monks are gathered before a priest. There are four pedestals north of you, with the priest standing beside them.

You can see a Priest of Indra, Mahit, Basdev and Kastha here.

>x walls
There seems to be walls nearby, but you can't see them with your eyes.

>x wall
You can't see any such thing.

>x x
You can't see any such thing.

* * *

>x walls
There seems to be walls nearby, but you can't see them with your eyes.

>touch walls
It's cold to the touch. You reckon this is just a concrete wall.

>n
MausoleuE
 Darkness looms left and right. You feel like you're not alone.

>touch walls
It's cold to the touch. You reckon this is just a concrete wall.

>w
MausoleuC
 Darkness looms left and right. You feel like you're not alone.

>touch walls
Actually, you can't find any walls in this part.

* * *

Temple of Indra
You find yourself in a religious ceremony. Three of your fellow monks are gathered before a priest. There are four pedestals north of you, with the priest standing beside them.

You can see a Priest of Indra, Mahit, Basdev and Kastha here.

>punch wall
You punch wall the wall and it comes tumbling down. The wall is already broken

>w
MausoleuS
 Darkness looms left and right. You feel like you're not alone.

* * *

>w
MausoleuSW
 Darkness looms left and right. You feel like you're not alone.

>punch wall
You punch the wall, but it doesn't seem to do anything. Now your hand hurts.

>s
You try to walk south, but you hit a wall.

* * *

>w
MausoleuS
 Darkness looms left and right. You feel like you're not alone.

>punch wall
You punch the wall, but it doesn't seem to do anything. Now your hand hurts.

* * *

>punch wall
You punch wall the wall and it comes tumbling down. The wall is already broken

>s
You try to walk south, but you hit a wall.

* * *

>w
MausoleuS
 Darkness looms left and right. You feel like you're not alone.

>punch wall
You punch the wall and it comes tumbling down. The wall is broken

* * *

>punch wall
You punch wall the wall and it comes tumbling down. The wall is already broken

>kick wall
The wall is already broken

>n
MausoleuE
 Darkness looms left and right. You feel like you're not alone.

>kick wall
You kick wall the wall, but it doesn't seem to do anything. A great way to hurt your hand.

>attack wall
You attack wall the wall, but it doesn't seem to do anything. A great way to hurt your hand.

>break wall
You break wall the wall, but it doesn't seem to do anything. A great way to hurt your hand.

* * *

Temple of Indra
You find yourself in a religious ceremony. Three of your fellow monks are gathered before a priest. There are four pedestals north of you, with the priest standing beside them.

You can see a Priest of Indra, Mahit, Basdev and Kastha here.

>s[
That's not a verb I recognise.

>s
You try to walk south, but you hit a wall.

>s
You try to walk south, but you hit a wall.

* * *

Temple of Indra
You find yourself in a religious ceremony. Three of your fellow monks are gathered before a priest. There are four pedestals north of you, with the priest standing beside them.

You can see a Priest of Indra, Mahit, Basdev and Kastha here.

>go to MausoleuNW
You can't see any such thing.

>n
MausoleuE
 Darkness looms left and right. You feel like you're not alone.

I beg your pardon?

* * *

Temple of Indra
You find yourself in a religious ceremony. Three of your fellow monks are gathered before a priest. There are four pedestals north of you, with the priest standing beside them.

You can see a Priest of Indra, Mahit, Basdev and Kastha here.

>nw
You try to walk northwest, but you hit a wall.

>w
MausoleuS
 Darkness looms left and right. You feel like you're not alone.

>n
MausoleuC
 Darkness looms left and right. You feel like you're not alone.

>nw
You try to walk northwest, but you hit a wall.

>n
MausoleuN
 Darkness looms left and right. You feel like you're not alone.

* * *

>w
You try to walk west, but you hit a wall.

>x
What do you want to examine?

>lid
You see nothing special about the lid.

>x elevation
You see nothing special about the elevation.

>open elevation
It's too dark to see the opening.

* * *

>nw
You try to walk northwest, but you hit a wall.

>n
MausoleuE
 Darkness looms left and right. You feel like you're not alone.

* * *

Temple of Indra
You find yourself in a religious ceremony. Three of your fellow monks are gathered before a priest. There are four pedestals north of you, with the priest standing beside them.

You can see a Priest of Indra, Mahit, Basdev and Kastha here.

>break wall
You attacking the wall and it comes tumbling down. The wall is already broken

* * *

Temple of Indra
You find yourself in a religious ceremony. Three of your fellow monks are gathered before a priest. There are four pedestals north of you, with the priest standing beside them.

You can see a Priest of Indra, Mahit, Basdev and Kastha here.

>kick wall
You attacking the wall and it comes tumbling down.

* * *

Temple of Indra
You find yourself in a religious ceremony. Three of your fellow monks are gathered before a priest. There are four pedestals north of you, with the priest standing beside them.

You can see a Priest of Indra, Mahit, Basdev and Kastha here.

>touch elevation
You can't see any such thing.

* * *

Temple of Indra
You find yourself in a religious ceremony. Three of your fellow monks are gathered before a priest. There are four pedestals north of you, with the priest standing beside them.

You can see a Priest of Indra, Mahit, Basdev and Kastha here.

>touch a pta
You can't see any such thing.

* * *

Temple of Indra
You find yourself in a religious ceremony. Three of your fellow monks are gathered before a priest. There are four pedestals north of you, with the priest standing beside them.

You can see a Priest of Indra, Mahit, Basdev and Kastha here.

>x me
As good-looking as ever.

>x you
You can't see any such thing.

>look at me
As good-looking as ever.

* * *

Temple of Indra
You find yourself in a religious ceremony. Three of your fellow monks are gathered before a priest. There are four pedestals north of you, with the priest standing beside them.

You can see a Priest of Indra, Mahit, Basdev and Kastha here.

>take rat
You try to take a rat with you, but are too scared to do so, given the situation.

>x rat
You see nothing special about the rat.

>x teh rat
You can't see any such thing.

>x me
As good-looking as ever.

>inventory
You are carrying nothing.

>eat rat
You pick one of the filthy animals and take a bite out of it. You have all the diseases now. Was that worth it?

* * *

Temple of Indra
You find yourself in a religious ceremony. Three of your fellow monks are gathered before a priest. There are four pedestals north of you, with the priest standing beside them.

You can see a Priest of Indra, Mahit, Basdev and Kastha here.

>x rat
You can't see much, but you notice there are more rats than you expected there to be! That's dangerous!

>take all
dark wall: Taken.

* * *

Temple of Indra
You find yourself in a religious ceremony. Three of your fellow monks are gathered before a priest. There are four pedestals north of you, with the priest standing beside them.

You can see a Priest of Indra, Mahit, Basdev and Kastha here.

>take all
There are none at all available!

* * *

Temple of Indra
You find yourself in a religious ceremony. Three of your fellow monks are gathered before a priest. There are four pedestals north of you, with the priest standing beside them.

You can see a Priest of Indra, Mahit, Basdev and Kastha here.

>S
p2
You run south for a few moments until you reach a wall. The hallway bifurcates to each of your sides, but you see a dim light to your right.

>w
p3
You run towards the light and find out that there are a few fireflies coming from your left. There is another path straight ahead as well.

* * *

>s
p4
You run south, feeling the wind blow through your hair. You have no option but to keep running forward.

>s
p5
After running a few more meters, you find a wall with a window, from where the wind was blowing. To the right of the window, there's a path with old bookshelves. To the left of the window, there is a path with a few statues of the gods.

You hear a loud sound coming from the ceremonial room. The Asura must have broken through the doors. Run, NOW!

>e
p6
You run through the hallway past several statues until you reach a wall. The hallway continues south.

* * *

Temple of Indra
You find yourself in a religious ceremony. Three of your fellow monks are gathered before a priest. There are four pedestals north of you, with the priest standing beside them.

You can see a Priest of Indra, Mahit, Basdev and Kastha here.

>down
You can't go that way.

* * *

Temple of Indra
You find yourself in a religious ceremony. Three of your fellow monks are gathered before a priest. There are four pedestals north of you, with the priest standing beside them.

You can see a Priest of Indra, Mahit, Basdev and Kastha here.

>jump through north
You must name something more substantial.

>s
Temple Hallway
You run south for a few moments until you reach a wall. The hallway bifurcates to each of your sides, but you see a dim light to your right.

* * *

>w
Temple Hallway
You run towards the light and find out that there are a few fireflies coming from your left. There is another path straight ahead as well.

>s
Temple Hallway
You run south, feeling the wind blow through your hair. You have no option but to keep running forward.

You hear a loud sound coming from the ceremonial room. The Asura must have broken through the doors. Run, NOW!

>s
Temple Hallway
After running a few more meters, you find a wall with a window, from where the wind was blowing. To the right of the window, there's a path with old bookshelves. To the left of the window, there is a path with a few statues of the gods.

>jump through window
*** You jump through the window and fall to your death. ***

Would you like to RESTART, RESTORE a saved game, QUIT or UNDO the last command?

>undo
Temple Hallway
[Previous turn undone.]

>jump thru window
*** You jump through the window and fall to your death. ***

Would you like to RESTART, RESTORE a saved game, QUIT or UNDO the last command?

* * *

Temple of Indra
You find yourself in a religious ceremony. Three of your fellow monks are gathered before a priest. There are four pedestals north of you, with the priest standing beside them.

You can see a Priest of Indra, Mahit, Basdev and Kastha here.

>jump in
You try to jump in, but the trap door is still closed. You hurt your buttocks, but your pride hurts more after such shame.

>jump in trapdoor
You try to jump in, but the trap door is still closed. You hurt your buttocks, but your pride hurts more after such shame.

>x trapdoor
You see nothing special about the trapdoor.

>open trapdoor
You open the trap door. There's no backing off now, you have no other option but to jump in.

You hear a loud sound coming from the ceremonial room. The Asura must have broken through the doors. Run, NOW!

>d
You jump. You have no idea where this will lead you or how high is the fall, but you have no regrets.

MausoleuSE
Darkness looms left and right. No sign of your pursuer, but you should be cautious anyway.

* * *

Temple of Indra
You find yourself in a religious ceremony. Three of your fellow monks are gathered before a priest. There are four pedestals north of you, with the priest standing beside them.

You can see a Priest of Indra, Mahit, Basdev and Kastha here.

>d
You try to jump in, but the trap door is still closed.  You hurt your buttocks, but your pride hurts more after such shame.

>d
(first opening the trapdoor)
You open the trap door. There's no backing off now, you have no other option but to jump in.

* * *

>open trapdoor
You open the trap door. There's no backing off now, you have no other option but to jump in.

>d
You jump. You have no idea where this will lead you or how high is the fall, but you have no regrets.

MausoleuSE
Darkness looms left and right. No sign of your pursuer, but you should be cautious anyway.

After descending in that hole, you passed away in an unknown place. Little by little, you open your eyes, just to realize you can't actually see anything. You can't tell if you're blind or if it's just really dark. Thankfully, your other senses seems to be working just fine.

* * *

>open trapdoor
You open the trap door. There's no backing off now, you have no other option but to jump in.

>s
You can't go that way.

>d
You jump. You have no idea where this will lead you or how high is the fall, but you have no regrets.

MausoleuSE
Darkness looms left and right. No sign of your pursuer, but you should be cautious anyway.

After descending in that hole, you passed away in an unknown place. Little by little, you open your eyes, just to realize you can't actually see anything. You can't tell if you're blind or if it's just really dark. Thankfully, your other senses seems to be working just fine.

You hear a loud sound coming from the ceremonial room. The Asura must have broken through the doors. Run, NOW!

* * *

>d
You try to jump in, but the trap door is still closed.  You hurt your buttocks, but your pride hurts more after such shame.

>go though trapdoor
You can't see any such thing.

>go through trapdoor
You try to jump in, but the trap door is still closed. You hurt your buttocks, but your pride hurts more after such shame.

>jump thru trapdoor
You try to jump in, but the trap door is still closed. You hurt your buttocks, but your pride hurts more after such shame.

>open trapdoor
You open the trap door. There's no backing off now, you have no other option but to jump in.

You hear a loud sound coming from the ceremonial room. The Asura must have broken through the doors. Run, NOW!

>go through trapdoor
You jump. You have no idea where this will lead you or how high is the fall, but you have no regrets.

MausoleuSE
Darkness looms left and right. No sign of your pursuer, but you should be cautious anyway.

* * *

>d
You try to jump in, but the trap door is still closed.  You hurt your buttocks, but your pride hurts more after such shame.

>[enter]
You hurt your buttocks, but your pride hurts more after such shame.

>take trapdoor
That's fixed in place.

* * *

Temple of Indra
You find yourself in a religious ceremony. Three of your fellow monks are gathered before a priest. There are four pedestals north of you, with the priest standing beside them.

You can see a Priest of Indra, Mahit, Basdev and Kastha here.

>open trapdoor
You open the trap door. There's no backing off now, you have no other option but to jump in.

* * *

>d
You jump. You have no idea where this will lead you or how high is the fall, but you have no regrets.

???
 After descending in that hole, you passed away in an unknown place. Little by little, you open your eyes, just to realize you can't actually see anything. You can't tell if you're blind or if it's just really dark. Thankfully, your other senses seems to be working just fine.

>look
Small Room
You find yourself in a dead-end. There's not much in this room other than a small trap door near the wall. In fear of what is coming for you, you decide that opening it and jumping in is all you can do to try and survive.

* * *

>d
You jump. You have no idea where this will lead you or how high is the fall, but you have no regrets.

???
 After descending in that hole, you passed away in an unknown place. Little by little, you open your eyes, just to realize you can't actually see anything. You can't tell if you're blind or if it's just really dark. Thankfully, your other senses seems to be working just fine.

>z
Time passes.

>z
Time passes.

You hear a loud sound coming from the ceremonial room. The Asura must have broken through the doors. Run, NOW!

>z
Time passes.

* * *

I beg your pardon?

>z
Time passes.

>zzzzzz
That's not a verb I recognise.

>z
Time passes.

>zz
That's not a verb I recognise.

>z
Time passes.

* * *

I beg your pardon?

>v
That's not a verb I recognise.

>z
Time passes.

>look
???
Darkness looms left and right. No sign of your pursuer, but you should be cautious anyway.

>listen
You hear a faint buzzling sound. You still can't pinpoint its location, though.

>n
???
Darkness looms left and right. No sign of your pursuer, but you should be cautious anyway.

>s
???
Darkness looms left and right. No sign of your pursuer, but you should be cautious anyway.

>s
You try to walk south, but you hit a wall.

* * *

>d
You jump. You have no idea where this will lead you or how high is the fall, but you have no regrets.

???
 After descending in that hole, you passed away in an unknown place. Little by little, you open your eyes, just to realize you can't actually see anything. You can't tell if you're blind or if it's just really dark. Thankfully, your other senses seems to be working just fine.

>n
You walk a little to the north, being careful to not bump on any walls or anything on the floor.

???
Darkness looms left and right. No sign of your pursuer, but you should be cautious anyway.

>w
You walk a little to the west, being careful to not bump on any walls or anything on the floor.

???
Darkness looms left and right. No sign of your pursuer, but you should be cautious anyway.

You hear a loud sound coming from the ceremonial room. The Asura must have broken through the doors. Run, NOW!

>e
You walk a little to the east, being careful to not bump on any walls or anything on the floor.

???
Darkness looms left and right. No sign of your pursuer, but you should be cautious anyway.

>e
You try to walk east, but you hit a wall.

>x floor
You can feel the floor under your feet, but you can't see it.

>touch floor
You feel nothing unexpected.

* * *

>w
You try to walk west, but you hit a wall.

>touch wall
It's cold to the touch. You reckon this is just a concrete wall.

>listen
The buzzling sound seems to be higher. Its source must be close.

>n
You walk a little to the north, being careful to not bump on any walls or anything on the floor.

???
Darkness looms left and right. No sign of your pursuer, but you should be cautious anyway.

>listen
Wow. The buzzling sound is really high here. Maybe this is the source.

>help
That's not a verb I recognise.

>touch floor
you scan the floor and find

>s
You walk a little to the south, being careful to not bump on any walls or anything on the floor.

???
Darkness looms left and right. No sign of your pursuer, but you should be cautious anyway.

* * *

>take all
There are none at all available!

* * *

>d
You jump. You have no idea where this will lead you or how high is the fall, but you have no regrets.

???
 After descending in that hole, you passed away in an unknown place. Little by little, you open your eyes, just to realize you can't actually see anything. You can't tell if you're blind or if it's just really dark. Thankfully, your other senses seems to be working just fine.

>touch wall
It's cold to the touch. You reckon this is just a concrete wall.

>smell
You hear a loud sound coming from the ceremonial room. The Asura must have broken through the doors. Run, NOW!

>w
You walk a little to the west, being careful to not bump on any walls or anything on the floor.

???
Darkness looms left and right. No sign of your pursuer, but you should be cautious anyway.

>w
You walk a little to the west, being careful to not bump on any walls or anything on the floor.

???
Darkness looms left and right. No sign of your pursuer, but you should be cautious anyway.

>touch wall
You scan the wall with your hand and a feel cracks all around its surface. It's so run-down even a punch could break it.

>smell
The wet grass must be here. It's smell is somehow pleasing.

>break wal
You can't see any such thing.

>break wall
You attack the wall and it comes tumbling down. 
After breaking the wall, light comes from the adjacent room.  You can see again. Yay!

Mausoleu

* * *

>d
You jump. You have no idea where this will lead you or how high is the fall, but you have no regrets.

???
 After descending in that hole, you passed away in an unknown place. Little by little, you open your eyes, just to realize you can't actually see anything. You can't tell if you're blind or if it's just really dark. Thankfully, your other senses seems to be working just fine.

>w
You walk a little to the west, being careful to not bump on any walls or anything on the floor.

???
Darkness looms left and right. No sign of your pursuer, but you should be cautious anyway.

>w
You walk a little to the west, being careful to not bump on any walls or anything on the floor.

???
Darkness looms left and right. No sign of your pursuer, but you should be cautious anyway.

You hear a loud sound coming from the ceremonial room. The Asura must have broken through the doors. Run, NOW!

>w
You try to walk west, but you hit a wall.

* * *

>break wall
You attack the wall and it comes tumbling down. 

After breaking the wall, a burst of light comes from outside. On the edge of the hole caused by your punch, you can see some burn marks. It seems the wall iselft was the source of the smell. 
Thankfully, you can see the room now.

Mausoleu

>x elevation
examining the tomb

>look elevation
examining the tomb

* * *

>break wall
You attack the wall and it comes tumbling down. 

After breaking the wall, a burst of light comes from outside. On the edge of the hole caused by your punch, you can see some burn marks. It seems the wall iselft was the source of the smell. 
Thankfully, you can see the room now.

Mausoleu

>x tomb
The tomb is richly embellished with golden intricate inlay. The lid is also very fancy. A real deal to tomb raiders.

>x walls
The walls of the mausoleum are fully engraved in a language you don't understand, but you guess those are spells.
You notice a flame symbol next to the wall you busted. Maybe a fire spell that went wrong?

>x wall
You can't see any such thing.

>restart
Are you sure you want to restart?

>y
Small Room
You find yourself in a dead-end. There's not much in this room other than a small trap door near the wall. In fear of what is coming for you, you decide that opening it and jumping in is all you can do to try and survive.

Small Room
You find yourself in a dead-end. There's not much in this room other than a small trap door near the wall. In fear of what is coming for you, you decide that opening it and jumping in is all you can do to try and survive.

>open trapdoor
You open the trap door. There's no backing off now, you have no other option but to jump in.

* * *

>n
You walk a little to the north, being careful to not bump on any walls or anything on the floor.

???
Darkness looms left and right. No sign of your pursuer, but you should be cautious anyway.

>n
You walk a little to the north, being careful to not bump on any walls or anything on the floor.

???
Darkness looms left and right. No sign of your pursuer, but you should be cautious anyway.

You hear a loud sound coming from the ceremonial room. The Asura must have broken through the doors. Run, NOW!

>w
You walk a little to the west, being careful to not bump on any walls or anything on the floor.

???
Darkness looms left and right. No sign of your pursuer, but you should be cautious anyway.

* * *

>touch floor
You scan the floor with your foot and feel an elevation somehere amidst the dark.

>xelevation
That's not a verb I recognise.

>x elevation
You can't see what the elevation is, it's too dark.

* * *

>touch elevation
The elevation seems to to be about a human's size. You also feel a small gap all around the top of it, like a lid.

>open elevation
(the elevation)
You push the lid and it falls to the side of the elevation.

White light comes bursting out of the elevation.  When you can finally see again, a giant sprit in the shape of a firefly towers over you. He says "eae men" and flies way, leaving a magic light source, so you can explore the now lit room.

Mausoleu

>x tomb
The tomb is richly embellished with golden intricate inlay. The lid that once held the light spirit now sits on floor next to the tomb.

>x walls
The walls of the mausoleum are fully engraved in a language you don't understand, but you guess those are spells to keep the light spirit trapped in this room. If that is, how were you able to free him? You wonder....

* * *

>w
You try to walk west, but you hit a wall.

I beg your pardon?

>break wall
You attack the wall and it comes tumbling down. 

After breaking the wall, a burst of light comes from outside. On the edge of the hole caused by your punch, you can see some burn marks. It seems the wall iselft was the source of the smell. 
Thankfully, you can see the room now.

Mausoleu

* * *

>x elevation
A tomb in the shoutwest of the room matches perfectly the elevation you bumped into when the room was dark.

>restart
Are you sure you want to restart?

* * *

>w
You try to walk west, but you hit a wall.

>punch wall
That's not a verb I recognise.

>attack wall
That's not a verb I recognise.

* * *

>w
You walk a little to the west, being careful to not bump on any walls or anything on the floor.

???
Darkness looms left and right. No sign of your pursuer, but you should be cautious anyway.

You hear a loud sound coming from the ceremonial room. The Asura must have broken through the doors. Run, NOW!

I beg your pardon?

* * *

>break wall
You attack the wall and it comes tumbling down. 

After breaking the wall, a burst of light comes from outside. On the edge of the hole caused by your punch, you can see some burn marks. It seems the wall iselft was the source of the smell. 
Thankfully, you can see the room now.

Mausoleu

>x elevation
x elevation

* * *

>open trapdoor
You open the trap door. There's no backing off now, you have no other option but to jump in.

>jump in
You jump. You have no idea where this will lead you or how high is the fall, but you have no regrets.

???
 After descending in that hole, you passed away in an unknown place. Little by little, you open your eyes, just to realize you can't actually see anything. You can't tell if you're blind or if it's just really dark. Thankfully, your other senses seems to be working just fine.

>n
You walk a little to the north, being careful to not bump on any walls or anything on the floor.

???
Darkness looms left and right. No sign of your pursuer, but you should be cautious anyway.

>s
You walk a little to the south, being careful to not bump on any walls or anything on the floor.

???
Darkness looms left and right. No sign of your pursuer, but you should be cautious anyway.

You hear a loud sound coming from the ceremonial room. The Asura must have broken through the doors. Run, NOW!

>s
You try to walk south, but you hit a wall.

>w
You walk a little to the west, being careful to not bump on any walls or anything on the floor.

???
Darkness looms left and right. No sign of your pursuer, but you should be cautious anyway.

* * *

>w
You try to walk west, but you hit a wall.

>listen
You hear a faint buzzling sound. You still can't pinpoint its location, though.

>smell
The wet grass must be here. It's smell is somehow pleasing.

>x wall
There seems to be walls nearby, but you can't see them with your eyes.

>touch wall
You scan the wall with your hand and a feel cracks all around its surface. It's so run-down even a punch could break it.

>n
You walk a little to the north, being careful to not bump on any walls or anything on the floor.

???
Darkness looms left and right. No sign of your pursuer, but you should be cautious anyway.

>touch wall
It's cold to the touch. You reckon this is just a concrete wall.

>s
You walk a little to the south, being careful to not bump on any walls or anything on the floor.

???
Darkness looms left and right. No sign of your pursuer, but you should be cautious anyway.

>break wall
You attack the wall, but it doesn't seem to do anything. A great way to hurt your hand.

>touch wall
You scan the wall with your hand and a feel cracks all around its surface. It's so run-down even a punch could break it.

>punch wall
You attack the wall, but it doesn't seem to do anything. A great way to hurt your hand.

* * *

>jump in
You jump. You have no idea where this will lead you or how high is the fall, but you have no regrets.

???
 After descending in that hole, you passed away in an unknown place. Little by little, you open your eyes, just to realize you can't actually see anything. You can't tell if you're blind or if it's just really dark. Thankfully, your other senses seems to be working just fine.

>s
You try to walk south, but you hit a wall.

>e
You try to walk east, but you hit a wall.

You hear a loud sound coming from the ceremonial room. The Asura must have broken through the doors. Run, NOW!

>e
You try to walk east, but you hit a wall.

* * *

>touch wall
It's cold to the touch. You reckon this is just a concrete wall.

>s
You try to walk south, but you hit a wall.

>e
You try to walk east, but you hit a wall.

>break wall
You attack the wall and it comes tumbling down.

>break wall
The wall is already broken

* * *

>s
You try to walk south, but you hit a wall.

>s
You try to walk south, but you hit a wall.

You hear a loud sound coming from the ceremonial room. The Asura must have broken through the doors. Run, NOW!

>touch wall
You scan the wall with your hand and a feel cracks all around its surface. It's so run-down even a punch could break it.

>w
You walk a little to the west, being careful to not bump on any walls or anything on the floor.

???
Darkness looms left and right. No sign of your pursuer, but you should be cautious anyway.

* * *

>s
You try to walk south, but you hit a wall.

>w
You walk a little to the west, being careful to not bump on any walls or anything on the floor.

???
Darkness looms left and right. No sign of your pursuer, but you should be cautious anyway.

You hear a loud sound coming from the ceremonial room. The Asura must have broken through the doors. Run, NOW!

* * *

>w
You try to walk west, but you hit a wall.

>break wall
You attack the wall and it comes tumbling down. 
After breaking the wall, a burst of light comes from outside. On the edge of the hole caused by your punch, you can see some burn marks. It seems the wall iselft was the source of the smell. Thankfully, you can see the wall now.

>s
You try to walk south, but you hit a wall.

>look
???
Darkness looms left and right. No sign of your pursuer, but you should be cautious anyway.

* * *

>jump in
You jump. You have no idea where this will lead you or how high is the fall, but you have no regrets.

???
 After descending in that hole, you passed away in an unknown place. Little by little, you open your eyes, just to realize you can't actually see anything. You can't tell if you're blind or if it's just really dark. Thankfully, your other senses seems to be working just fine.

>touch wall
You scan the wall with your hand and a feel cracks all around its surface. It's so run-down even a punch could break it.

>w
You walk a little to the west, being careful to not bump on any walls or anything on the floor.

???
Darkness looms left and right. No sign of your pursuer, but you should be cautious anyway.

You hear a loud sound coming from the ceremonial room. The Asura must have broken through the doors. Run, NOW!

>touch wall
It's cold to the touch. You reckon this is just a concrete wall.

>e
You walk a little to the east, being careful to not bump on any walls or anything on the floor.

???
Darkness looms left and right. No sign of your pursuer, but you should be cautious anyway.

>touch wall
You scan the wall with your hand and a feel cracks all around its surface. It's so run-down even a punch could break it.

>s
You try to walk south, but you hit a wall.

* * *

>jump in
You jump. You have no idea where this will lead you or how high is the fall, but you have no regrets.

???
 After descending in that hole, you passed away in an unknown place. Little by little, you open your eyes, just to realize you can't actually see anything. You can't tell if you're blind or if it's just really dark. Thankfully, your other senses seems to be working just fine.

>w
You walk a little to the west, being careful to not bump on any walls or anything on the floor.

???
Darkness looms left and right. No sign of your pursuer, but you should be cautious anyway.

* * *

>w
You walk a little to the west, being careful to not bump on any walls or anything on the floor.

???
Darkness looms left and right. No sign of your pursuer, but you should be cautious anyway.

You hear a loud sound coming from the ceremonial room. The Asura must have broken through the doors. Run, NOW!

>s
You try to walk south, but you hit a wall.

>w
You try to walk west, but you hit a wall.

>break wall
You attack the wall and it comes tumbling down. 

After breaking the wall, a burst of light comes from outside. On the edge of the hole caused by your punch, you can see some burn marks. It seems the wall iselft was the source of the smell. Thankfully, you can see the room now.

Mausoleu

>x
What do you want to examine?

>sealed tomb
You see nothing special about Sealed tomb.

* * *

>open trapdoor
You open the trap door. There's no backing off now, you have no other option but to jump in.

>undo
Small Room
[Previous turn undone.]

>open trapdoor
You open the trap door. There's no backing off now, you have no other option but to jump in.

* * *

>w
You try to walk west, but you hit a wall.

>break wall
You attack the wall and it comes tumbling down. 
After breaking the wall, a burst of light comes from outside. On the edge of the hole caused by your punch, you can see some burn marks. It seems the wall iselft was the source of the smell. Thankfully, you can see the room now.

* * *

>open trapdoor
You open the trap door. There's no backing off now, you have no other option but to jump in.

>w
You can't go that way.

>jump in
You jump. You have no idea where this will lead you or how high is the fall, but you have no regrets.

???
 After descending in that hole, you passed away in an unknown place. Little by little, you open your eyes, just to realize you can't actually see anything. You can't tell if you're blind or if it's just really dark. Thankfully, your other senses seems to be working just fine.

>w
You walk a little to the west, being careful to not bump on any walls or anything on the floor.

???
Darkness looms left and right. No sign of your pursuer, but you should be cautious anyway.

You hear a loud sound coming from the ceremonial room. The Asura must have broken through the doors. Run, NOW!

* * *

>w
You walk a little to the west, being careful to not bump on any walls or anything on the floor.

???
Darkness looms left and right. No sign of your pursuer, but you should be cautious anyway.

I beg your pardon?

* * *

>break wall
You attack the wall and it comes tumbling down. 

After breaking the wall, a burst of light comes from outside. On the edge of the hole caused by your punch, you can see some burn marks. It seems the wall iselft was the source of the smell. 
Thankfully, you can see the room now.

Mausoleu

>x tomb
examining the tomb

>x elevation
examining the tomb

* * *

Temple of Indra
You find yourself in a religious ceremony. Three of your fellow monks are gathered before a priest. There are four pedestals north of you, with the priest standing beside them.

You can see a Priest of Indra, Mahit, Basdev and Kastha here.

>enter trapdoor
You try to jump in, but the trap door is still closed. You hurt your buttocks, but your pride hurts more after such shame.

* * *

Temple of Indra
You find yourself in a religious ceremony. Three of your fellow monks are gathered before a priest. There are four pedestals north of you, with the priest standing beside them.

You can see a Priest of Indra, Mahit, Basdev and Kastha here.

>open door
You can't see any such thing.

>open trapdoor
You open the trap door. There's no backing off now, you have no other option but to jump in.

* * *

>d
You jump. You have no idea where this will lead you or how high is the fall, but you have no regrets.

???
 After descending in that hole, you passed away in an unknown place. Little by little, you open your eyes, just to realize you can't actually see anything. You can't tell if you're blind or if it's just really dark. Thankfully, your other senses seems to be working just fine.

>x
What do you want to examine?

I beg your pardon?

>look
???
Darkness looms left and right. No sign of your pursuer, but you should be cautious anyway.

>x all
You can't use multiple objects with that verb.

>smell
You hear a loud sound coming from the ceremonial room. The Asura must have broken through the doors. Run, NOW!

* * *

>listen
You hear a faint buzzling sound. You still can't pinpoint its location, though.

* * *

Temple of Indra
You find yourself in a religious ceremony. Three of your fellow monks are gathered before a priest. There are four pedestals north of you, with the priest standing beside them.

You can see a Priest of Indra, Mahit, Basdev and Kastha here.

>attack a with b
You can't see any such thing.

* * *

Temple of Indra
You find yourself in a religious ceremony. Three of your fellow monks are gathered before a priest. There are four pedestals north of you, with the priest standing beside them.

You can see a Priest of Indra, Mahit, Basdev and Kastha here.

>inventory
You are carrying:
  a sword

* * *

>attack jorge with sua mae
You can't see any such thing.

>attack jorge with piru
You can't see any such thing.

* * *

>attack jorge
Violence isn't the answer to this one.

* * *

Temple of Indra
You find yourself in a religious ceremony. Three of your fellow monks are gathered before a priest. There are four pedestals north of you, with the priest standing beside them.

You can see a Priest of Indra, Mahit, Basdev and Kastha here.

>hold dido
You can't see any such thing.

>hold dildo
You already have that.

>hold sword
You already have that.

* * *

>hit jorge
That's not a verb I recognise.

>attack jorge
What do you want to attack Jorge with?

>dildo
You hear a loud sound coming from the ceremonial room. The Asura must have broken through the doors. Run, NOW!

>attack
What do you want to attack Jorge with?

* * *

Temple of Indra
You find yourself in a religious ceremony. Three of your fellow monks are gathered before a priest. There are four pedestals north of you, with the priest standing beside them.

You can see a Priest of Indra, Mahit, Basdev and Kastha here.

>attack
Whom do you want to attack?

>dilma
What do you want to attack Dilma with?

* * *

>hit
That's not a verb I recognise.

* * *

Temple of Indra
You find yourself in a religious ceremony. Three of your fellow monks are gathered before a priest. There are four pedestals north of you, with the priest standing beside them.

You can see a Priest of Indra, Mahit, Basdev and Kastha here.

>hit
Whom do you want to hit?

>dilma
What do you want to hit Dilma with?

* * *

>attack jorge
What do you want to attack Jorge with?

>word
You can't see any such thing.

>sword
What do you want to do something to the sword combined with?

>hit
Whom do you want to hit?

* * *

>sword
What do you want to do something to the sword combined with?

>attack dilma
What do you want to attack Dilma with?

* * *

Temple of Indra
You find yourself in a religious ceremony. Three of your fellow monks are gathered before a priest. There are four pedestals north of you, with the priest standing beside them.

You can see a Priest of Indra, Mahit, Basdev and Kastha here.

>attack Kastha with sword
You can't see any such thing.

>attack Kastha
You can't see any such thing.

* * *

Temple of Indra
You find yourself in a religious ceremony. Three of your fellow monks are gathered before a priest. There are four pedestals north of you, with the priest standing beside them.

You can see a Priest of Indra, Mahit, Basdev and Kastha here.

>attack kastha with dildo
Dildo does not qualify as a weapon.

* * *

Temple of Indra
You find yourself in a religious ceremony. Three of your fellow monks are gathered before a priest. There are four pedestals north of you, with the priest standing beside them.

You can see a Priest of Indra, Mahit, Basdev and Kastha here.

>attack Mahit with fire sword
You attack with Fire Sword, killing Mahit!

>attack Mahit with fire sword
You can't see any such thing.

>attack Basdev with earth sword
You attack with Earth Sword, killing Basdev!

>attack kastha with air sword
You can't see any such thing.

>attack kastha with wind sword
You attack Kastha with Wind Sword, causing 0 points of damage!

>attack kastha with fire sword
You attack with Fire Sword, killing Kastha!

You hear a loud sound coming from the ceremonial room. The Asura must have broken through the doors. Run, NOW!

* * *

Temple of Indra
You find yourself in a religious ceremony. Three of your fellow monks are gathered before a priest. There are four pedestals north of you, with the priest standing beside them.

You can see a Priest of Indra, Mahit, Basdev and Kastha here.

>attack kastha with fire sword
You attack with Fire Sword, killing Kastha!

* * *

Temple of Indra
You find yourself in a religious ceremony. Three of your fellow monks are gathered before a priest. There are four pedestals north of you, with the priest standing beside them.

You can see a Priest of Indra, Mahit, Basdev and Kastha here.

>attack mahit with earth sword
You attack Mahit with Earth Sword, causing 0 points of damage!

Mahit attacks you with Bhaumastra, causing 1 point of damage!

Basdev attacks you with Agneyastra, causing 2 points of damage!

Kastha attacks you with Vayvayastra, causing 1 point of damage!

>attack mahit with fire sword
1
You attack with Fire Sword, killing Mahit!

>attack kastha with earth sword
2
You attack with Earth Sword, killing Kastha!

* * *

>attack mahit with earth sword
You attack Mahit with Earth Sword, causing 0 points of damage!

Mahit attacks you with Bhaumastra, causing 1 point of damage!

Basdev attacks you with Agneyastra, causing 2 points of damage!

Kastha attacks you with Vayvayastra, causing 1 point of damage!

>attack mahit with wind sword
You attack Mahit with Wind Sword, causing 2 points of damage!

Mahit attacks you with Bhaumastra, causing 1 point of damage!

Basdev attacks you with Agneyastra, causing 2 points of damage!

Kastha attacks you with Vayvayastra, causing 1 point of damage!

* * *

Temple of Indra
You find yourself in a religious ceremony. Three of your fellow monks are gathered before a priest. There are four pedestals north of you, with the priest standing beside them.

You can see a Priest of Indra, Mahit, Basdev and Kastha here.

>attack kastha with air sword
You can't see any such thing.

>attack kastha with wind sword
You attack Kastha with Wind Sword, causing 0 points of damage!

Mahit attacks you with Bhaumastra, causing 1 point of damage!

Basdev attacks you with Agneyastra, causing 2 points of damage!

Kastha attacks you with Vayvayastra, causing 1 point of damage!

>attack kastha with fire sword
1
You attack Kastha with Fire Sword, causing 1 point of damage!

>attack kastha with earth sword
2
You attack with Earth Sword, killing Kastha!

* * *

Temple of Indra
You find yourself in a religious ceremony. Three of your fellow monks are gathered before a priest. There are four pedestals north of you, with the priest standing beside them.

You can see a Priest of Indra, Mahit, Basdev and Kastha here.

>attack kastha with earth sword
2
You attack Kastha with Earth Sword, causing 2 points of damage!

>attack kastha with earth sword
2
You attack with Earth Sword, killing Kastha!

>attack kastha with earth sword
2
You attack with Earth Sword, killing Kastha!

>attack kastha with earth sword
2
You attack with Earth Sword, killing Kastha!

You hear a loud sound coming from the ceremonial room. The Asura must have broken through the doors. Run, NOW!

>attack kastha with earth sword
2
You attack with Earth Sword, killing Kastha!

I beg your pardon?

* * *

Temple of Indra
You find yourself in a religious ceremony. Three of your fellow monks are gathered before a priest. There are four pedestals north of you, with the priest standing beside them.

You can see a Priest of Indra, Mahit, Basdev and Kastha here.

>attack kastha with the earth sword
2
You attack Kastha with Earth Sword, causing 2 points of damage!

* * *

Temple of Indra
You find yourself in a religious ceremony. Three of your fellow monks are gathered before a priest. There are four pedestals north of you, with the priest standing beside them.

You can see a Priest of Indra, Mahit, Basdev and Kastha here.

>attack mahit with water sword
1
You attack Mahit with Water Sword, causing 1 point of damage!

>attack mahit with fire sword
1
You attack Mahit with Fire Sword, causing 1 point of damage!

>attack mahit with fire sword
1
You attack Mahit with Fire Sword, causing 1 point of damage!

>attack mahit with fire sword
1
Mahit is dead!

You attack with Fire Sword, killing Mahit!

You hear a loud sound coming from the ceremonial room. The Asura must have broken through the doors. Run, NOW!

>attack mahit with fire sword
1
Mahit is dead!

You attack with Fire Sword, killing Mahit!

* * *

>attack mahit with water sword
1
You attack Mahit with Water Sword, causing 1 point of damage!

>attack mahit with water sword
1
You attack Mahit with Water Sword, causing 1 point of damage!

>attack mahit with water sword
1
You attack with Water Sword, killing Mahit!

* * *

Temple of Indra
You find yourself in a religious ceremony. Three of your fellow monks are gathered before a priest. There are four pedestals north of you, with the priest standing beside them.

You can see a Priest of Indra, Mahit, Basdev and Kastha here.

>attack mahit with fire sword
You attack Mahit with Fire Sword, causing 1 point of damage!

Mahit attacks you with Bhaumastra, causing 1 point of damage!

Basdev attacks you with Agneyastra, causing 2 points of damage!

Kastha attacks you with Vayvayastra, causing 1 point of damage!

>look
Final Room
You can see Mahit, Basdev and Kastha here.

* * *

>attack mahit with fire sword
You attack Mahit with Fire Sword, causing 1 point of damage!

Mahit attacks you with Bhaumastra, causing 1 point of damage!

Basdev attacks you with Agneyastra, causing 2 points of damage!

Kastha attacks you with Vayvayastra, causing 1 point of damage!

>attack mahit with fire sword
You attack with Fire Sword, killing Mahit!

Basdev attacks you with Agneyastra, causing 2 points of damage!

Kastha attacks you with Vayvayastra, causing 1 point of damage!

>attack basdev with fire sword
You attack Basdev with Fire Sword, causing 0 points of damage!

Basdev attacks you with Agneyastra, finishing you off!

Kastha attacks you with Vayvayastra, finishing you off!

    *** The End ***

Would you like to RESTART, RESTORE a saved game, QUIT or UNDO the last command?

>restart
Final Room
You can see Mahit, Basdev and Kastha here.

>attack basdev with water sword
You attack with Water Sword, killing Basdev!

Mahit attacks you with Bhaumastra, causing 1 point of damage!

Kastha attacks you with Vayvayastra, causing 1 point of damage!

>attack kastha with earth sword
You attack with Earth Sword, killing Kastha!

Mahit attacks you with Bhaumastra, causing 1 point of damage!

>attack mahit with wind sword
You attack with Wind Sword, killing Mahit!

>restart
Are you sure you want to restart?

>y
Final Room
You can see Mahit, Basdev and Kastha here.

>attack mahit with earth sword
You attack Mahit with Earth Sword, causing 0 points of damage!

Mahit attacks you with Bhaumastra, causing 1 point of damage!

Basdev attacks you with Agneyastra, causing 2 points of damage!

Kastha attacks you with Vayvayastra, causing 1 point of damage!

>attack mahit with earth sword
You attack Mahit with Earth Sword, causing 0 points of damage!

Mahit attacks you with Bhaumastra, causing 1 point of damage!

Basdev attacks you with Agneyastra, causing 2 points of damage!

Kastha attacks you with Vayvayastra, finishing you off!

    *** The End ***

Would you like to RESTART, RESTORE a saved game, QUIT or UNDO the last command?

>restart
Final Room
You can see Mahit, Basdev and Kastha here.

>x yourself
You can't see any such thing.

>x you
You can't see any such thing.

>x self
As good-looking as ever.

>x kalinda
You can't see any such thing.

* * *

Temple of Indra
You find yourself in a religious ceremony. Three of your fellow monks are gathered before a priest. There are four pedestals north of you, with the priest standing beside them.

You can see a Priest of Indra, Mahit, Basdev and Kastha here.

>attack mahit with air sword
You can't see any such thing.

>attack mahit with wind sword
2
You attack Mahit with Wind Sword, causing 2 points of damage!

>attack mahit with wind sword
2
You attack with Wind Sword, killing Mahit!

>attack mahit with wind sword
2
You attack with Wind Sword, killing Mahit!

* * *

Temple of Indra
You find yourself in a religious ceremony. Three of your fellow monks are gathered before a priest. There are four pedestals north of you, with the priest standing beside them.

You can see a Priest of Indra, Mahit, Basdev and Kastha here.

>attack kastha with wind word
I only understood you as far as wanting to attack Kastha with Wind Sword.

>attack kastha with wind sword
You attack Kastha with Wind Sword, causing 0 points of damage!

Mahit attacks you with Bhaumastra, causing 1 point of damage!

Basdev attacks you with Agneyastra, causing 2 points of damage!

Kastha attacks you with Vayvayastra, causing 1 point of damage!

>attack kastha with earth sword
You attack Kastha with Earth Sword, causing 2 points of damage!

Mahit attacks you with Bhaumastra, causing 1 point of damage!

Basdev attacks you with Agneyastra, causing 2 points of damage!

Kastha attacks you with Vayvayastra, causing 1 point of damage!

>attack mahit with fire sword
You attack Mahit with Fire Sword, causing 1 point of damage!

yourself is dead!

Mahit attacks you with Bhaumastra, finishing you off!

yourself is dead!

Basdev attacks you with Agneyastra, finishing you off!

yourself is dead!

Kastha attacks you with Vayvayastra, finishing you off!

    *** The End ***

Would you like to RESTART, RESTORE a saved game, QUIT or UNDO the last command?

* * *

Temple of Indra
You find yourself in a religious ceremony. Three of your fellow monks are gathered before a priest. There are four pedestals north of you, with the priest standing beside them.

You can see a Priest of Indra, Mahit, Basdev and Kastha here.

>vai te fuder
That's not a verb I recognise.

* * *

Temple of Indra
You find yourself in a religious ceremony. Three of your fellow monks are gathered before a priest. There are four pedestals north of you, with the priest standing beside them.

You can see a Priest of Indra, Mahit, Basdev and Kastha here.

>x kalinda
As good-looking as ever.

* * *

Temple of Indra
You find yourself in a religious ceremony. Three of your fellow monks are gathered before a priest. There are four pedestals north of you, with the priest standing beside them.

You can see a Priest of Indra, Mahit, Basdev and Kastha here.

>x Mahit
You see nothing special about Asura Mahit.

>attack mahit with fire sword
You attack Asura Mahit with Fire Sword, causing 1 point of damage!

Asura Mahit attacks you with Bhaumastra, causing 1 point of damage!

Asura Basdev attacks you with Agneyastra, causing 2 points of damage!

Asura Kastha attacks you with Vayvayastra, causing 1 point of damage!

* * *

Temple of Indra
You find yourself in a religious ceremony. Three of your fellow monks are gathered before a priest. There are four pedestals north of you, with the priest standing beside them.

You can see a Priest of Indra, Mahit, Basdev and Kastha here.

>x Asura Mahit
You see nothing special about Asura Mahit.

>x Mahit
You see nothing special about Asura Mahit.

>x Basdev
You see nothing special about Asura Basdev.

>x Kastha
You see nothing special about Asura Kastha.

You hear a loud sound coming from the ceremonial room. The Asura must have broken through the doors. Run, NOW!

* * *

Temple of Indra
You find yourself in a religious ceremony. Three of your fellow monks are gathered before a priest. There are four pedestals north of you, with the priest standing beside them.

You can see a Priest of Indra, Mahit, Basdev and Kastha here.

>x priest
The priest is a calm, pacient man. He's wearing orange robes and is looking at the four of you.

>x mahit
Mahit is a short monk in green robes. He seems bored.

>x basdev
Basdev is a tall monk in red robes. His eyes scream conviction and seriousness.

>x kastha
Kastha is a young monk in yellow robes. She's the only female among you. She seems a little scaried.

* * *

Temple of Indra
You find yourself in a religious ceremony. Three of your fellow monks are gathered before a priest. There are four pedestals north of you, with the priest standing beside them.

You can see a Priest of Indra, Mahit, Basdev and Kastha here.

>talk to priest about past
You ask the priest of Indra about what exactly happened in the past.
"Ah... so noone has told you about it yet, huh? I should've anticipated it. That is no children's story. Very well..."
"For the past few generations, during the Celestial Boon Ceremony, we have gathered the top four monks of the kingdom to receive the gifts of the gods."
"We believe that only those of strong body and spirit are capable of inheriting such power. As such, we have noticed a pattern."
"In every group of four, there is always one monk that succumbs to their desires and transforms into a power hungry Asura. We believe that Ravana, the King of Demons, might be involved in some way."
"The birth of an Asura and slaughter of demigods would surely be of use to him. Because of that, we plan to make a gamble: if three of you become demigods, the fourth shall be detained before the worst happens."
"However, if an Asura is born before the three heroes emerge, we shall need to fight handicapped."

>talk to priest about the past
There is no reply.

* * *

Temple of Indra
You find yourself in a religious ceremony. Three of your fellow monks are gathered before a priest. There are four pedestals north of you, with the priest standing beside them.

You can see a Priest of Indra, Mahit, Basdev and Kastha here.

>talk to priest about the past
You ask the priest of Indra about what exactly happened in the past.
"Ah... so noone has told you about it yet, huh? I should've anticipated it. That is no children's story. Very well..."
"For the past few generations, during the Celestial Boon Ceremony, we have gathered the top four monks of the kingdom to receive the gifts of the gods."
"We believe that only those of strong body and spirit are capable of inheriting such power. As such, we have noticed a pattern."
"In every group of four, there is always one monk that succumbs to their desires and transforms into a power hungry Asura. We believe that Ravana, the King of Demons, might be involved in some way."
"The birth of an Asura and slaughter of demigods would surely be of use to him. Because of that, we plan to make a gamble: if three of you become demigods, the fourth shall be detained before the worst happens."
"However, if an Asura is born before the three heroes emerge, we shall need to fight handicapped."

>talk to priest about the incident
You ask the priest of Indra about what exactly happened in the past.
"Ah... so noone has told you about it yet, huh? I should've anticipated it. That is no children's story. Very well..."
"For the past few generations, during the Celestial Boon Ceremony, we have gathered the top four monks of the kingdom to receive the gifts of the gods."
"We believe that only those of strong body and spirit are capable of inheriting such power. As such, we have noticed a pattern."
"In every group of four, there is always one monk that succumbs to their desires and transforms into a power hungry Asura. We believe that Ravana, the King of Demons, might be involved in some way."
"The birth of an Asura and slaughter of demigods would surely be of use to him. Because of that, we plan to make a gamble: if three of you become demigods, the fourth shall be detained before the worst happens."
"However, if an Asura is born before the three heroes emerge, we shall need to fight handicapped."

* * *

Temple of Indra
You find yourself in a religious ceremony. Three of your fellow monks are gathered before a priest. There are four pedestals north of you, with the priest standing beside them.

You can see a Priest of Indra, Mahit, Basdev and Kastha here.

>ask the priest about the past
There is no reply.

>[enter]
"Ah... so noone has told you about it yet, huh? I should've anticipated it. That is no children's story. Very well..."

>a
"For the past few generations, during the Celestial Boon Ceremony, we have gathered the top four monks of the kingdom to receive the gifts of the gods."

>a
"We believe that only those of strong body and spirit are capable of inheriting such power. As such, we have noticed a pattern."

>a
"In every group of four, there is always one monk that succumbs to their desires and transforms into a power hungry Asura. We believe that Ravana, the King of Demons, might be involved in some way."

>s
"The birth of an Asura and slaughter of demigods would surely be of use to him. Because of that, we plan to make a gamble: if three of you become demigods, the fourth shall be detained before the worst happens."

>d
"However, if an Asura is born before the three heroes emerge, we shall need to fight handicapped."

I beg your pardon?

* * *

Temple of Indra
You find yourself in a religious ceremony. Three of your fellow monks are gathered before a priest. There are four pedestals north of you, with the priest standing beside them.

You can see a Priest of Indra, Mahit, Basdev and Kastha here.

>ask priest
What do you want to ask the Priest of Indra for?

>nothing
You can't see any such thing.

>ask priest about nothing
There is no reply.

* * *

>ask priest
What do you want to ask the Priest of Indra for?

>npthing
You can't see any such thing.

* * *

>talk to priest about past
You ask the priest of Indra about what exactly happened in the past.

>[enter]
"Ah... so noone has told you about it yet, huh? I should've anticipated it. That is no children's story. Very well..."

>[enter]
"For the past few generations, during the Celestial Boon Ceremony, we have gathered the top four monks of the kingdom to receive the gifts of the gods."

>[enter]
"We believe that only those of strong body and spirit are capable of inheriting such power. As such, we have noticed a pattern."

>[enter]
"In every group of four, there is always one monk that succumbs to their desires and transforms into a power hungry Asura. We believe that Ravana, the King of Demons, might be involved in some way."

>[enter]
"The birth of an Asura and slaughter of demigods would surely be of use to him. Because of that, we plan to make a gamble: if three of you become demigods, the fourth shall be detained before the worst happens."

>[enter]
"However, if an Asura is born before the three heroes emerge, we shall need to fight handicapped."

* * *

Temple of Indra
You find yourself in a religious ceremony. Three of your fellow monks are gathered before a priest. There are four pedestals north of you, with the priest standing beside them.

You can see a Priest of Indra, Mahit, Basdev and Kastha here.

>ask the priest
What do you want to ask the Priest of Indra for?

>ask the priest abou the past
I didn't understand that sentence.

* * *

Temple of Indra
You find yourself in a religious ceremony. Three of your fellow monks are gathered before a priest. There are four pedestals north of you, with the priest standing beside them.

You can see a Priest of Indra, Mahit, Basdev and Kastha here.

>ask
Whom do you want to ask?

>ask priest
What do you want to ask the Priest of Indra for?

>ask priest about nothing
Hello, young Kalinda. I am the priest of Indra, and these three are the others that you might've heard about: Mahit, Basdev and Kastha.
I must congratulate each one of you for achieving what you just did. Not everyone can become one of the top four monks of the kingdom. As per tradition, each one of you shall receive the blessings of a god.
I have taken the precautions based on that past incident. Each of you will have to learn of the abilities of each of your fellow monks, and then we shall procede by granting each of your boons one at a time.

* * *

>ask
Whom do you want to ask?

>ask
Whom do you want to ask?

I beg your pardon?

>ask
Whom do you want to ask?

>ask the priest
What do you want to ask the Priest of Indra for?

>ask
Whom do you want to ask?

>talk
Whom do you want to talk to?

* * *

Temple of Indra
You find yourself in a religious ceremony. Three of your fellow monks are gathered before a priest. There are four pedestals north of you, with the priest standing beside them.

You can see a Priest of Indra, Mahit, Basdev and Kastha here.

>talk to the priest
"Hello, young Kalinda. I am the priest of Indra, and these three are the others that you might've heard about: Mahit, Basdev and Kastha."

>talk to the priest about past
You ask the priest of Indra about what exactly happened in the past.

>[enter]
"Ah... so noone has told you about it yet, huh? I should've anticipated it. That is no children's story. Very well..."

* * *

>[enter]
"However, if an Asura is born before the three heroes emerge, we shall need to fight handicapped."

I beg your pardon?

* * *

>talk to the priest
"Hello, young Kalinda. I am the priest of Indra, and these three are the others that you might've heard about: Mahit, Basdev and Kastha."

>[enter]
"I must congratulate each one of you for achieving what you just did. Not everyone can become one of the top four monks of the kingdom. As per tradition, each one of you shall receive the blessings of a god."

>[enter]
"I have taken the precautions based on that past incident. Each of you will have to learn of the abilities of each of your fellow monks, and then we shall procede by granting each of your boons one at a time."

I beg your pardon?

>talk to mahit
"Hey man, how's it going?"

>[enter]
"You must be that Kalinda dude the priest mentioned, right?"

>[enter]
"Man, all this chitchat before the boon is pretty boring, dontcha think?"

>[enter]
"Let's just get straight to the point, "k?"

>[enter]
"I know you're a follower of Varuna, I've studied those. No need to explain anything to me, "k?"

>[enter]
"You don't look like you've done your homework, so Imma tell you about my good ol" Bhaumastra."

>[enter]
"Y'see, to a layman, it's just a spear, but it can easily pierce and control the earth."

>[enter]
"All I did was combine a long metal shaft with a very hard rock and a lotus flower."

>[enter]
"The magic of Mother Bhumi comes from the lotus flowers, dontcha forget that!"

I beg your pardon?

>talk to basdev
"Greetings, friend. So you must be Kalinda, right?"

>[enter]
"Well, I'll have you explain your abilities first, as per the priest of Indra's instructions."

>[enter]
You explain to Basdev about the intricacies of your personal skills.

>[enter]
"Ah, so that's how you fight."

>[enter]
"Very well."

>[enter]
"As was agreed, I shall explain my skills."

>[enter]
"As a follower of Lord Agni, I fight with the Agneyastra, a bow that shoots flaming arrows."

>[enter]
"The Agneyastra is made by combining a bow and a fire arrow."

>[enter]
"The bow is made by combining a wooden stick and a string, while the fire arrow is made by combining a wooden stick with a holy charcoal."

>[enter]
"I hope we can win many battles together, brother."

>talk to kastha
"Hello! So you're Kalinda! Pleased to meet you, I'm Kastha!"

>[enter]
"Well, the priest said some stuff about a past incident... I'm kinda scared, but I'll try and stay positive!"

>[enter]
"So, since he asked us to tell each other of our powers, I'll begin by introducing mine!"

>[enter]
"Inspired by Lord Vayu, I wield the great Vayvayastra mace! It's a magical mace that can create whirlwinds just by swinging it!"

>[enter]
"You see, it was forged by combining a heavy metal shaft, a round bronze head and snake scales. A true Naga hunter's weapon!"

>[enter]
"So, what about yours?"

>[enter]
You explain to her about the weapon you've trained with and how you fight.

>[enter]
"Wow, that sounds exciting! I do hope to see you slay several Asura."

>[enter]
"But not more than me, haha!"

Temple Hallway
After leaving the ceremonial room, you find yourself in a hallway. To the west and to the east, you see doors. To the south, there's a straight path.

>look
Temple Hallway
After leaving the ceremonial room, you find yourself in a hallway. To the west and to the east, you see doors. To the south, there's a straight path.

* * *

Temple of Indra
You find yourself in a religious ceremony. Three of your fellow monks are gathered before a priest. There are four pedestals north of you, with the priest standing beside them.

You can see a Priest of Indra, Mahit, Basdev and Kastha here.

>talk to priest
"Hello, young Kalinda. I am the priest of Indra, and these three are the others that you might've heard about: Mahit, Basdev and Kastha."

>talk to priest about past
You ask the priest of Indra about what exactly happened in the past.

* * *

>talk to priest
"Hello, young Kalinda. I am the priest of Indra, and these three are the others that you might've heard about: Mahit, Basdev and Kastha."

>[enter]
"I must congratulate each one of you for achieving what you just did. Not everyone can become one of the top four monks of the kingdom. As per tradition, each one of you shall receive the blessings of a god."

* * *

>[enter]
"I have taken the precautions based on that past incident. Each of you will have to learn of the abilities of each of your fellow monks, and then we shall procede by granting each of your boons one at a time."

>talk to the priest about the past
You ask the priest of Indra about what exactly happened in the past.

>[enter]
"Ah... so noone has told you about it yet, huh? I should've anticipated it. That is no children's story. Very well..."

* * *

I beg your pardon?

>talk to priest abou the past
I only understood you as far as wanting to talk to the Priest of Indra.

I beg your pardon?

>talk to priest about the past
You ask the priest of Indra about what exactly happened in the past.

>[enter]
"Ah... so noone has told you about it yet, huh? I should've anticipated it. That is no children's story. Very well..."

* * *

I beg your pardon?

>talk to kastha
"Hello! So you're Kalinda! Pleased to meet you, I'm Kastha!"

* * *

>[enter]
"Wow, that sounds exciting! I do hope to see you slay several Asura."

>[enter]
"But not more than me, haha!"

>talk to basdev
"Greetings, friend. So you must be Kalinda, right?"

* * *

>[enter]
"I hope we can win many battles together, brother."

>attack priest
What do you want to attack the Priest of Indra with?

>attack priest with bow
You can't see any such thing.

>take all
There are none at all available!

* * *

Temple of Indra
You find yourself in a religious ceremony. Three of your fellow monks are gathered before a priest. There are four pedestals north of you, with the priest standing beside them.

You can see a Priest of Indra, Mahit, Basdev and Kastha here.

>talk to mahit
"Hello there, pal! I think we should talk to the priest guy over there first. We can chat later!"

>talk to priest
"Hello, young Kalinda. I am the priest of Indra, and these three are the others that you might've heard about: Mahit, Basdev and Kastha."

* * *

>[enter]
"The bow is made by combining a wooden stick and a string, while the fire arrow is made by combining a wooden stick with a holy charcoal."

>[enter]
"I hope we can win many battles together, brother."

The priest draws the attention of all four of you, announcing that the ceremony is about to begin.

>[enter]
"Warriors! I believe there is nothing else we can do but procede with the ritual."

>[enter]
"I shall ask each of you to stand on the pedestal of the god you've worshipped during your training."

>[enter]
"Mahit, you're first! Come to the pedestal of Bhumi."

>[enter]
As Mahit stands on the pedestal, the priest starts chanting a hymn in an ancient language.

>[enter]
All of a sudden... Mahit turns into an Asura!!

>[enter]
"Ah yes, such beautiful power!"

>[enter]
The priest is... pleased?

>[enter]
What the hell is going on!?

>[enter]
"Basdev, you're next! Come quickly to the pedestal of Agni!"

>[enter]
Basdev stands on the pedestal and the same scene occurs once more.

>[enter]
You start to feel uneasy.

>[enter]
"Kastha, it's your turn now. You are the first woman to reach this rank! Don't disappoint Lord Vayu!"

>[enter]
As you feared, the moment Kastha stepped onto the pedestal, the priest chanted that hymn and she turned into a third Asura.

>[enter]
The three Asura look at you as the angry priest yells: "Get him!"

>[enter]
You run south, seeking a way to escape.

>[enter]
Temple Hallway
After leaving the ceremonial room, you find yourself in a hallway. To the west and to the east, you see doors. To the south, there's a straight path.

>s
Temple Hallway
You run south for a few moments until you reach a wall. The hallway bifurcates to each of your sides, but you see a dim light to your right.

* * *

>s
There's a window to the south. Perhaps you could go through it?

>jump thru window
*** You jump through the window and fall to your death. ***

Would you like to RESTART, RESTORE a saved game, QUIT or UNDO the last command?

>undo
Temple Hallway
[Previous turn undone.]

>w
Library
You go to the path with the bookshelves, but it leads to an old library. There's nothing of note inside, and you're in too much of a hurry to take your time here.

>e
Temple Hallway
You leave the library. To the north is the path to the ceremonial room. To the west is the library. To the south is the window. The hallway continues to the east, with a few statues of gods by the walls.

>e
Temple Hallway
You run through the hallway past several statues until you reach a wall. The hallway continues south.

* * *

>s
Temple Hallway
After running south, you see a rat come running from the path right in front of you. There's another path to the east. They're both dark and you can't see much.

>w
You can't go that way.

>e
Temple Hallway
You run east through the dark hallway. You have no option but to keep running forward.

>e
Temple Hallway

* * *

Temple of Indra
You find yourself in a religious ceremony. Three of your fellow monks are gathered before a priest. There are four pedestals north of you, with the priest standing beside them.

You can see a Priest of Indra, Mahit, Basdev and Kastha here.

>talk mahit
I didn't understand that sentence.

>talk to mahit
"Hello there, pal! I think we should talk to the priest guy over there first. We can chat later!"

>talk to kastha
Hi! I'm really nervous... maybe we should hear what the priest has to say first?

>talk to bastev
You can't see any such thing.

>talk to basdev
"Greetings. I believe the priest of Indra has something important to tell us."

>talk to priest
"Hello, young Kalinda. I am the priest of Indra, and these three are the others that you might've heard about: Mahit, Basdev and Kastha."

* * *

>[enter]
"I must congratulate each one of you for achieving what you just did. Not everyone can become one of the top four monks of the kingdom. As per tradition, each one of you shall receive the blessings of a god."

>[enter]
"I have taken the precautions based on that past incident. Each of you will have to learn of the abilities of each of your fellow monks, and then we shall procede by granting each of your boons one at a time."

acabou

I beg your pardon?

* * *

Temple of Indra
You find yourself in a religious ceremony. Three of your fellow monks are gathered before a priest. There are four pedestals north of you, with the priest standing beside them.

You can see a Priest of Indra, Mahit, Basdev and Kastha here.

>GONEAR p1
Temple Hallway
After leaving the ceremonial room, you find yourself in a hallway. To the west and to the east, you see doors. To the south, there's a straight path.

>s
Temple Hallway
You run south for a few moments until you reach a wall. The hallway bifurcates to each of your sides, but you see a dim light to your right.

* * *

>s
Temple Hallway
After running south, you see a rat come running from the path right in front of you. There's another path to the east. They're both dark and you can't see much.

>e
Temple Hallway
You run east through the dark hallway. You have no option but to keep running forward.

>e
Temple Hallway
You keep running east. Your legs start to feel tired, but you have no option but to keep running forward.

>n
You can't go that way.

>e
Temple Hallway
You keep running until you reach a fork. On your left you see a door slightly open with some light coming out of it. On the other side you see the continuation of the same corridor, but increasingly dark.

>s
Dead end
You start running in this dark corridor until you hit your head in a wall. You check with your hands for any door but you find nothing. You have no business here.

>eat rat
You can't see any such thing.

>n
Temple Hallway
You reach the previous room. As you look to your left you see the Asura shadows getting bigger in the end of the corridor you came before. You better hurry.

>n
Temple Hallway
After crossing the door you are temporarily blinded by a beam of light, coming from a window in the upper corner of the room. As soon as your vision returns to normal, you notice a few tables and chairs around the place, nothing much. You keep moving towards the only door in the place.

>n
Temple Hallway
You see yourself in the meeting of two corridors. You notice a light breeze coming from the west. On the opposite side of the breeze you hear some sounds in the distance, but you cannot identify them. In front of you there is a door a few steps away. You cannot tell whether it's locked or not.

>n
Locked door
You run towards the door and try to open it. It's locked.

>w
You can't go that way.

>e
You can't go that way.

Asura arrives from the south.

>w
You can't go that way.

    *** It's too late! As you try to escape, you notice the Asura catching up behind you. Their bloodlust cannot be stopped! You try to run, but all that remains is your soulless corpse on the floor. 
 Game Over. ***

Would you like to RESTART, RESTORE a saved game, QUIT or UNDO the last command?

>undo
Locked door
[Previous turn undone.]

>undo
Locked door
[Previous turn undone.]

>undo
Temple Hallway
[Previous turn undone.]

* * *

Temple of Indra
You find yourself in a religious ceremony. Three of your fellow monks are gathered before a priest. There are four pedestals north of you, with the priest standing beside them.

You can see a Priest of Indra, Mahit, Basdev and Kastha here.

>gonear p1
Temple Hallway
After leaving the ceremonial room, you find yourself in a hallway. To the west and to the east, you see doors. To the south, there's a straight path.

>s
Temple Hallway
You run south for a few moments until you reach a wall. The hallway bifurcates to each of your sides, but you see a dim light to your right.

>z
Time passes.

>z
Time passes.

    *** It's too late! As you try to escape, you notice the Asura catching up behind you. Their bloodlust cannot be stopped! You try to run, but all that remains is your soulless corpse on the floor. 
 Game Over. ***

Would you like to RESTART, RESTORE a saved game, QUIT or UNDO the last command?

>restart
Temple of Indra
You find yourself in a religious ceremony. Three of your fellow monks are gathered before a priest. There are four pedestals north of you, with the priest standing beside them.

You can see a Priest of Indra, Mahit, Basdev and Kastha here.

>go near p1
You can't see any such thing.

>go near p1
You can't see any such thing.

>gonear p1
Temple Hallway
After leaving the ceremonial room, you find yourself in a hallway. To the west and to the east, you see doors. To the south, there's a straight path.

* * *

>e
Temple Hallway
You keep running east. Your legs start to feel tired, but you have no option but to keep running forward.

>e
Temple Hallway
You keep running until you reach a fork. On your left you see a door slightly open with some light coming out of it. On the other side you see the continuation of the same corridor, but increasingly dark.

>n
Temple Hallway
After crossing the door you are temporarily blinded by a beam of light, coming from a window in the upper corner of the room. As soon as your vision returns to normal, you notice a few tables and chairs around the place, nothing much. You keep moving towards the only door in the place.

* * *

>n
Temple Hallway
You see yourself in the meeting of two corridors. You notice a light breeze coming from the west. On the opposite side of the breeze you hear some sounds in the distance, but you cannot identify them. In front of you there is a door a few steps away. You cannot tell whether it's locked or not.

>w
Temple Hallway
With the last of your strenght, you face one final door to the south. There's not much else you can do now but to go through it.

>e
You try going east, but you remember that's where the Asura are coming from. You give up on that idea and decide to look for another option.

>s
Small Room
You find yourself in a dead-end. There's not much in this room other than a small trap door near the wall. In fear of what is coming for you, you decide that opening it and jumping in is all you can do to try and survive.

>open trapdoor
You open the trap door. There's no backing off now, you have no other option but to jump in.

* * *

>jump in
You jump. You have no idea where this will lead you or how high is the fall, but you have no regrets.

???
 After descending in that hole, you passed away in an unknown place. Little by little, you open your eyes, just to realize you can't actually see anything. You can't tell if you're blind or if it's just really dark. Thankfully, your other senses seems to be working just fine.

>listen
You hear a faint buzzling sound. You still can't pinpoint its location, though.

>hear
What do you want to hear?

>smell
You smell a faint odor of something burnt. It's really weak, though.

>w
You walk a little to the west, being careful to not bump on any walls or anything on the floor.

???
Darkness looms left and right. No sign of your pursuer, but you should be cautious anyway.

>listen
You hear a faint buzzling sound. You still can't pinpoint its location, though.

>w
You walk a little to the west, being careful to not bump on any walls or anything on the floor.

???
Darkness looms left and right. No sign of your pursuer, but you should be cautious anyway.

>x floor
You can feel the floor under your feet, but you can't see it.

>w
You try to walk west, but you hit a wall.

>smell
The burnt smell is really suffocating here. It seems to be coming from the wall.

>touch wall
You scan the wall with your hand and a feel cracks all around its surface. It's so run-down even a punch could break it.

>break wall
You attack the wall and it comes tumbling down. 

After breaking the wall, a burst of light comes from outside. On the edge of the hole caused by your punch, you can see some burn marks. It seems the wall iselft was the source of the smell. 
Thankfully, you can see the room now.

Mausoleum

>x tomb
The tomb is richly embellished with golden intricate inlay. The lid is also very fancy. A real deal to tomb raiders.

>x wall
The walls of the mausoleum are fully engraved in a language you don't understand, but you guess those are spells.
You notice a flame symbol next to the wall you busted. Maybe a fire spell that went wrong?

>x elevation
A tomb in the shoutwest of the room matches perfectly the elevation you bumped into when the room was dark. 
The tomb is richly embellished with golden intricate inlay. The lid is also very fancy. A real deal to tomb raiders.

* * *

Temple of Indra
You find yourself in a religious ceremony. Three of your fellow monks are gathered before a priest. There are four pedestals north of you, with the priest standing beside them.

You can see a Priest of Indra, Mahit, Basdev and Kastha here.

>gonear mausoleu SW
There seems to be no such object anywhere in the model world.

>gonear mausoleuNW
???
 After descending in that hole, you passed away in an unknown place. Little by little, you open your eyes, just to realize you can't actually see anything. You can't tell if you're blind or if it's just really dark. Thankfully, your other senses seems to be working just fine.

>x floor
You can feel the floor under your feet, but you can't see it.

>touch floor
You scan the floor with your foot, but can't find anything.

>n
You try to walk north, but you hit a wall.

>w
You walk a little to the west, being careful to not bump on any walls or anything on the floor.

???
Darkness looms left and right. No sign of your pursuer, but you should be cautious anyway.

* * *

>w
You try to walk west, but you hit a wall.

>touch floor
You scan the floor with your foot and feel an elevation somehere amidst the dark.

>x elevationb
You can't see what the elevation is, it's too dark.

>x elevation
You can't see what the elevation is, it's too dark.

* * *

>x lid
You see nothing special about the lid.

>touch lid
You feel nothing unexpected.

>open the lid
It isn't something you can open.

>open the elevation
(the elevation)
You push the lid and it falls to the side of the elevation.

I beg your pardon?

* * *

>look
???
Darkness looms left and right. No sign of your pursuer, but you should be cautious anyway.

>x elevation
(the elevation)
You can't see what the elevation is, it's too dark.

>open the elevation
(the elevation)
You push the lid and it falls to the side of the elevation.

>push lid
You push the lid and it falls to the side of the elevation.

* * *

Temple of Indra
You find yourself in a religious ceremony. Three of your fellow monks are gathered before a priest. There are four pedestals north of you, with the priest standing beside them.

You can see a Priest of Indra, Mahit, Basdev and Kastha here.

>gonear mausoleuNW
???
 After descending in that hole, you passed away in an unknown place. Little by little, you open your eyes, just to realize you can't actually see anything. You can't tell if you're blind or if it's just really dark. Thankfully, your other senses seems to be working just fine.

>w
You walk a little to the west, being careful to not bump on any walls or anything on the floor.

???
Darkness looms left and right. No sign of your pursuer, but you should be cautious anyway.

>xtouch elevation
That's not a verb I recognise.

>touch elevation
The elevation seems to to be about a human's size. You also feel a small gap all around the top of it, like a lid.

>open elevation
(the elevation)
You push the lid and it falls to the side of the elevation.

* * *

Temple of Indra
You find yourself in a religious ceremony. Three of your fellow monks are gathered before a priest. There are four pedestals north of you, with the priest standing beside them.

You can see a Priest of Indra, Mahit, Basdev and Kastha here.

>tonear mausoleuSW
That's not a verb I recognise.

>gonear mausoleuNW
???
 After descending in that hole, you passed away in an unknown place. Little by little, you open your eyes, just to realize you can't actually see anything. You can't tell if you're blind or if it's just really dark. Thankfully, your other senses seems to be working just fine.

>open elevation
You can't see any such thing.

>w
You walk a little to the west, being careful to not bump on any walls or anything on the floor.

???
Darkness looms left and right. No sign of your pursuer, but you should be cautious anyway.

>open elevation
You can't find the opening. Try touching for a lid or something.

>touch lid
You can't see any such thing.

>x lid
You can't see any such thing.

>x elevation
You can't see what the elevation is, it's too dark.

* * *

>touch elevation
The elevation seems to to be about a human's size. You also feel a small gap all around the top of it, like a lid.

>touch lid
You feel nothing unexpected.

>open elevation
(the elevation)
You push the lid and it falls to the side of the elevation.

You open the elevation, revealing a light sprit.

* * *

Temple of Indra
You find yourself in a religious ceremony. Three of your fellow monks are gathered before a priest. There are four pedestals north of you, with the priest standing beside them.

You can see a Priest of Indra, Mahit, Basdev and Kastha here.

>goto mausoleunw
That's not a verb I recognise.

>gonear mausoleunw
???
 After descending in that hole, you passed away in an unknown place. Little by little, you open your eyes, just to realize you can't actually see anything. You can't tell if you're blind or if it's just really dark. Thankfully, your other senses seems to be working just fine.

>w
You walk a little to the west, being careful to not bump on any walls or anything on the floor.

???
Darkness looms left and right. No sign of your pursuer, but you should be cautious anyway.

>touch elevation
The elevation seems to to be about a human's size. You also feel a small gap all around the top of it, like a lid.

>open elevation
(the elevation)
You push the lid and it falls to the side of the elevation.

You open the elevation, revealing a light sprit.

>x light spirit
I only understood you as far as wanting to examine the light sprit.

>restart
Are you sure you want to restart?

>y
Temple of Indra
You find yourself in a religious ceremony. Three of your fellow monks are gathered before a priest. There are four pedestals north of you, with the priest standing beside them.

You can see a Priest of Indra, Mahit, Basdev and Kastha here.

>go to p14
You can't see any such thing.

>gonear p14
Small Room
You find yourself in a dead-end. There's not much in this room other than a small trap door near the wall. In fear of what is coming for you, you decide that opening it and jumping in is all you can do to try and survive.

>open trapdoor
You open the trap door. There's no backing off now, you have no other option but to jump in.

* * *

>n
You walk a little to the north, being careful to not bump on any walls or anything on the floor.

???
Darkness looms left and right. No sign of your pursuer, but you should be cautious anyway.

>n
You walk a little to the north, being careful to not bump on any walls or anything on the floor.

???
Darkness looms left and right. No sign of your pursuer, but you should be cautious anyway.

>w
You walk a little to the west, being careful to not bump on any walls or anything on the floor.

???
Darkness looms left and right. No sign of your pursuer, but you should be cautious anyway.

* * *

>w
You try to walk west, but you hit a wall.

>n
You try to walk north, but you hit a wall.

>touch elevation
The elevation seems to to be about a human's size. You also feel a small gap all around the top of it, like a lid.

* * *

Temple of Indra
You find yourself in a religious ceremony. Three of your fellow monks are gathered before a priest. There are four pedestals north of you, with the priest standing beside them.

You can see a Priest of Indra, Mahit, Basdev and Kastha here.

>gonear mausoleunw
???
 After descending in that hole, you passed away in an unknown place. Little by little, you open your eyes, just to realize you can't actually see anything. You can't tell if you're blind or if it's just really dark. Thankfully, your other senses seems to be working just fine.

* * *

>touch elevation
The elevation seems to to be about a human's size. You also feel a small gap all around the top of it, like a lid.

>open elevation
(the elevation)
You push the lid and it falls to the side of the elevation.

You open the elevation.

White light comes bursting out of the elevation.  When you can finally see again, a giant sprit in the shape of a firefly towers over you. He says "Thanks for freeing me, young Kalinda. I have been inside that coffin for millenia."

>[enter]
"Let me give you something in return". After saying that, the giant image flies away, leaving a magic light source, so you can explore the now lit room.

Mausoleum

* * *

>gonear mausoleunw
???
 After descending in that hole, you passed away in an unknown place. Little by little, you open your eyes, just to realize you can't actually see anything. You can't tell if you're blind or if it's just really dark. Thankfully, your other senses seems to be working just fine.

>n
You try to walk north, but you hit a wall.

>n
You try to walk north, but you hit a wall.

* * *

>w
You try to walk west, but you hit a wall.

>x floor
You can feel the floor under your feet, but you can't see it.

>touch floor
You scan the floor with your foot and feel an elevation somehere amidst the dark.

>touch elevation
The elevation seems to to be about a human's size. You also feel a small gap all around the top of it, like a lid.

* * *

>touch lid
You feel nothing unexpected.

>push lid
You push the lid and it falls to the side of the elevation.

You open the elevation.

White light comes bursting out of the elevation.  When you can finally see again, a giant sprit in the shape of a firefly towers over you. He says "Thanks for freeing me, young Kalinda. I have been inside that coffin for millenia."

>[enter]
"It is time for me to go now. Someone else needs you. But first, let me give you something in return. Farewell."

>[enter]
After saying that, the giant image flies away, leaving a magic light source, so you can explore the now lit room.

Mausoleum

>x tomb
The tomb is richly embellished with golden intricate inlay. The lid that once held the light spirit now sits on floor next to the tomb.

>x elevation
A tomb in the shoutwest of the room matches perfectly the elevation you opened when the room was dark. 
The tomb is richly embellished with golden intricate inlay. The lid that once held the light spirit now sits on floor next to the tomb.

>x walls
The walls of the mausoleum are fully engraved in a language you don't understand, but you guess that are spells to keep the light spirit trapped in this room. If that is, how were you able to free him? You wonder....
 You notice a flame symbol next  to the wall at the south west of the room. Maybe a fire spell that went wrong?

>look nw
You see nothing unexpected in that direction.

* * *

>open elevation
(the elevation)
You push the lid and it falls to the side of the elevation.

You open the elevation.

White light comes bursting out of the elevation.  When you can finally see again, a giant sprit in the shape of a firefly towers over you. He says "Thanks for freeing me, young Kalinda. I have been inside that coffin for millenia."

>[enter]
"It is time for me to go now. Someone else needs you. But first, let me give you something in return. Farewell."

>[enter]
After saying that, the giant image flies away, leaving a magic light source, so you can explore the now lit room.

Mausoleum
There is a big tomb next to the wall. You wonder what could be inside.

>x tomb
The size of the tomb matches perfectly with the size of the elevation you freed the light spirit from.

>look inside tomb
The tomb is empty.

>close tomb
You close the tomb.

>x tomb
The size of the tomb matches perfectly with the size of the elevation you freed the light spirit from.
The tomb is closed, but it doesn't seem to be locked.

* * *

Temple of Indra
You find yourself in a religious ceremony. Three of your fellow monks are gathered before a priest. There are four pedestals north of you, with the priest standing beside them.

You can see a Priest of Indra, Mahit, Basdev and Kastha here.

>gonear mausoleusw
???
 After descending in that hole, you passed away in an unknown place. Little by little, you open your eyes, just to realize you can't actually see anything. You can't tell if you're blind or if it's just really dark. Thankfully, your other senses seems to be working just fine.

>s
You try to walk south, but you hit a wall.

* * *

>w
You walk a little to the west, being careful to not bump on any walls or anything on the floor.

???
Darkness looms left and right. No sign of your pursuer, but you should be cautious anyway.

>break wall
You attack the wall and it comes tumbling down. 

After breaking the wall, a burst of light comes from outside. On the edge of the hole caused by your punch, you can see some burn marks. It seems the wall iselft was the source of the smell. 
Thankfully, you can see the room now.

LSW

>w
You can't go that way.

>s
You can't go that way.

>n
LW

>n
LNW

>e
LN

>e
LNE

>s
LE

>s
LSE

>w
LS

>n
LC

>w
LW

>e
LC

>e
LE

>w
LC

>s
LS

>n
LC

>n
LN

>s
LC

* * *

Temple of Indra
You find yourself in a religious ceremony. Three of your fellow monks are gathered before a priest. There are four pedestals north of you, with the priest standing beside them.

You can see a Priest of Indra, Mahit, Basdev and Kastha here.

>gonear lsw
Mausoleum

>w
You can't go that way.

* * *

>s
You can't go that way.

>x tomb
The tomb is empty.

>look
Mausoleum

>open tomb
That's already open.

>close tomb
You close the tomb.

* * *

Temple of Indra
You find yourself in a religious ceremony. Three of your fellow monks are gathered before a priest. There are four pedestals north of you, with the priest standing beside them.

You can see a Priest of Indra, Mahit, Basdev and Kastha here.

>gonear mausoleu sw
There seems to be no such object anywhere in the model world.

>gonear mausoleusw
???
 After descending in that hole, you passed away in an unknown place. Little by little, you open your eyes, just to realize you can't actually see anything. You can't tell if you're blind or if it's just really dark. Thankfully, your other senses seems to be working just fine.

>n
You walk a little to the north, being careful to not bump on any walls or anything on the floor.

???
Darkness looms left and right. No sign of your pursuer, but you should be cautious anyway.

>n
You try to walk north, but you hit a wall.

* * *

>w
You try to walk west, but you hit a wall.

>touch elevation
The elevation seems to to be about a human's size. You also feel a small gap all around the top of it, like a lid.

* * *

>[enter]
After saying that, the giant image flies away, leaving a magic light source, so you can explore the now lit room.

Mausoleum

>w
You can't go that way.

>s
Mausoleum

>w
You can't go that way.

>n
Mausoleum

I beg your pardon?

>n
You can't go that way.

>x tomb
You can't see any such thing.

>n
You can't go that way.

>s
Mausoleum

>s
Mausoleum
There is a big tomb next to the wall. You wonder what could be inside.

* * *

>w
You walk a little to the west, being careful to not bump on any walls or anything on the floor.

???
Darkness looms left and right. No sign of your pursuer, but you should be cautious anyway.

>x florr
You can't see any such thing.

>touch floor
You scan the floor with your foot, but can't find anything.

>n
You walk a little to the north, being careful to not bump on any walls or anything on the floor.

???
Darkness looms left and right. No sign of your pursuer, but you should be cautious anyway.

* * *

>[enter]
After saying that, the giant image flies away, leaving a magic light source, so you can explore the now lit room.

Mausoleum
There is a big tomb next to the wall. You wonder what could be inside.

>open tomb
That's already open.

>x tomb
The tomb is empty.

>close tomb
You close the tomb.

>x tomb
You see nothing special about the tomb.

* * *

Temple of Indra
You find yourself in a religious ceremony. Three of your fellow monks are gathered before a priest. There are four pedestals north of you, with the priest standing beside them.

You can see a Priest of Indra, Mahit, Basdev and Kastha here.

>gonear lnw
Mausoleum
There is a big tomb next to the wall. You wonder what could be inside.

>x tomb
In the tomb is 3 Metal Heads.

>take one metal head
I only understood you as far as wanting to take 3 Metal Heads.

* * *

Temple of Indra
You find yourself in a religious ceremony. Three of your fellow monks are gathered before a priest. There are four pedestals north of you, with the priest standing beside them.

You can see a Priest of Indra, Mahit, Basdev and Kastha here.

>go near lnw
You can't see any such thing.

>gonear lnw
Mausoleum
There is a big tomb next to the wall. You wonder what could be inside.

>x tomb
In the tomb are three Metal heads.

>take one metal head
Taken.

>take one metal head
Taken.

>take one metal head
You already have that.

>x tomb
The tomb is empty.

>restart
Are you sure you want to restart?

* * *

>y
Temple of Indra
You find yourself in a religious ceremony. Three of your fellow monks are gathered before a priest. There are four pedestals north of you, with the priest standing beside them.

You can see a Priest of Indra, Mahit, Basdev and Kastha here.

>gonear mausoleusw
???
 After descending in that hole, you passed away in an unknown place. Little by little, you open your eyes, just to realize you can't actually see anything. You can't tell if you're blind or if it's just really dark. Thankfully, your other senses seems to be working just fine.

>w
You walk a little to the west, being careful to not bump on any walls or anything on the floor.

???
Darkness looms left and right. No sign of your pursuer, but you should be cautious anyway.

>gonear lsw
Mausoleum

>n
Mausoleum

>n
Mausoleum
There is a big tomb next to the wall. You wonder what could be inside.

>x tomb
In the tomb are three Metal heads.

>close tomb
You close the tomb.

>s tomb
I only understood you as far as wanting to (go) s.

>x tomb
The tomb is closed, but it doesn't seem to be locked.

>open tomb
You open the tomb, revealing three Metal heads.

>take one metal head
Taken.

>x tomb
In the tomb are two Metal heads.

* * *

Temple of Indra
You find yourself in a religious ceremony. Three of your fellow monks are gathered before a priest. There are four pedestals north of you, with the priest standing beside them.

You can see a Priest of Indra, Mahit, Basdev and Kastha here.

>gonear final room
Final Room
You can see Asura Mahit, Asura Basdev and Asura Kastha here.

>attach mahit with water sword
I didn't understand that sentence.

>attack mahit with water sword
You attack with Water Sword, killing Asura Mahit!

I didn't understand that instruction.

I didn't understand that instruction.

I didn't understand that instruction.

* * *

Temple of Indra
You find yourself in a religious ceremony. Three of your fellow monks are gathered before a priest. There are four pedestals north of you, with the priest standing beside them.

You can see a Priest of Indra, Mahit, Basdev and Kastha here.

>gonear final battle
I only understood you as far as wanting to gonear Final Room.

>gonear final room
Final Room
You can see Asura Mahit, Asura Basdev and Asura Kastha here.

>attack mahir with water sword
You can't see any such thing.

>attack mahit with water sword
You attack with Water Sword, killing Asura Mahit!

I didn't understand that instruction.

I didn't understand that instruction.

I didn't understand that instruction.

* * *

>gonear final room
Final Room
You can see Asura Mahit, Asura Basdev and Asura Kastha here.

>attack mahit with water sword
You attack with Water Sword, killing Asura Mahit!

I didn't understand that instruction.

I didn't understand that instruction.

I didn't understand that instruction.

* * *

>gonear final battle
I only understood you as far as wanting to gonear Final Room.

>gonear final
Final Room
You can see Asura Mahit, Asura Basdev and Asura Kastha here.

>attack mahit with water sword
You attack with Water Sword, killing Asura Mahit!

Asura Basdev attacks you with Agneyastra, causing 2 points of damage!

Asura Kastha attacks you with Vayvayastra, causing 1 point of damage!

* * *

Temple of Indra
You find yourself in a religious ceremony. Three of your fellow monks are gathered before a priest. There are four pedestals north of you, with the priest standing beside them.

You can see a Priest of Indra, Mahit, Basdev and Kastha here.

>go near final
You can't see any such thing.

>gonear final
Final Room
You can see Asura Mahit, Asura Basdev and Asura Kastha here.

>attach mahit with water sword
I didn't understand that sentence.

>attack mahit with water sword
You attack with Water Sword, killing Asura Mahit!

Asura Basdev attacks you with the Agneyastra, causing 2 points of damage!

Asura Kastha attacks you with the Vayvayastra, causing 1 point of damage!